<DrawSWF: void main(java.lang.String[])>/at.bestsolution.drawswf.MainWindow.<init>/0	<at.bestsolution.drawswf.MainWindow: void <init>()>
<DrawSWF: void main(java.lang.String[])>/at.bestsolution.drawswf.SplashScreen.<init>/0	<at.bestsolution.drawswf.SplashScreen: void <init>(javax.swing.JFrame,int)>
<DrawSWF: void main(java.lang.String[])>/at.bestsolution.drawswf.MainWindow.drawIt/0	<at.bestsolution.drawswf.MainWindow: void drawIt(at.bestsolution.drawswf.SplashScreen)>
<DrawSWF: void main(java.lang.String[])>/at.bestsolution.drawswf.MainWindow.setVisible/0	<java.awt.Component: void setVisible(boolean)>
<DrawSWF: void main(java.lang.String[])>/at.bestsolution.drawswf.SplashScreen.setVisible/0	<java.awt.Component: void setVisible(boolean)>
<DrawSWF: void main(java.lang.String[])>/at.bestsolution.drawswf.SplashScreen.dispose/0	<java.awt.Window: void dispose()>
<at.bestsolution.drawswf.DrawMenuBar: void <init>(at.bestsolution.drawswf.DrawObjectList)>/javax.swing.JMenuBar.<init>/0	<javax.swing.JMenuBar: void <init>()>
<at.bestsolution.drawswf.DrawMenuBar: void <init>(at.bestsolution.drawswf.DrawObjectList)>/at.bestsolution.drawswf.MainWindow.getI18n/0	<at.bestsolution.drawswf.MainWindow: java.util.ResourceBundle getI18n()>
<at.bestsolution.drawswf.DrawMenuBar: void <init>(at.bestsolution.drawswf.DrawObjectList)>/at.bestsolution.drawswf.MainWindow.getI18n/1	<at.bestsolution.drawswf.MainWindow: java.util.ResourceBundle getI18n()>
<at.bestsolution.drawswf.DrawMenuBar: void <init>(at.bestsolution.drawswf.DrawObjectList)>/at.bestsolution.drawswf.menu.DrawFileMenu.<init>/0	<at.bestsolution.drawswf.menu.DrawFileMenu: void <init>(java.lang.String,char)>
<at.bestsolution.drawswf.DrawMenuBar: void <init>(at.bestsolution.drawswf.DrawObjectList)>/at.bestsolution.drawswf.DrawMenuBar.add/0	<javax.swing.JMenuBar: javax.swing.JMenu add(javax.swing.JMenu)>
<at.bestsolution.drawswf.DrawMenuBar: void <init>(at.bestsolution.drawswf.DrawObjectList)>/at.bestsolution.drawswf.MainWindow.getI18n/2	<at.bestsolution.drawswf.MainWindow: java.util.ResourceBundle getI18n()>
<at.bestsolution.drawswf.DrawMenuBar: void <init>(at.bestsolution.drawswf.DrawObjectList)>/at.bestsolution.drawswf.MainWindow.getI18n/3	<at.bestsolution.drawswf.MainWindow: java.util.ResourceBundle getI18n()>
<at.bestsolution.drawswf.DrawMenuBar: void <init>(at.bestsolution.drawswf.DrawObjectList)>/at.bestsolution.drawswf.menu.DrawEditMenu.<init>/0	<at.bestsolution.drawswf.menu.DrawEditMenu: void <init>(java.lang.String,char)>
<at.bestsolution.drawswf.DrawMenuBar: void <init>(at.bestsolution.drawswf.DrawObjectList)>/at.bestsolution.drawswf.DrawMenuBar.add/1	<javax.swing.JMenuBar: javax.swing.JMenu add(javax.swing.JMenu)>
<at.bestsolution.drawswf.DrawMenuBar: void <init>(at.bestsolution.drawswf.DrawObjectList)>/at.bestsolution.drawswf.MainWindow.getI18n/4	<at.bestsolution.drawswf.MainWindow: java.util.ResourceBundle getI18n()>
<at.bestsolution.drawswf.DrawMenuBar: void <init>(at.bestsolution.drawswf.DrawObjectList)>/at.bestsolution.drawswf.MainWindow.getI18n/5	<at.bestsolution.drawswf.MainWindow: java.util.ResourceBundle getI18n()>
<at.bestsolution.drawswf.DrawMenuBar: void <init>(at.bestsolution.drawswf.DrawObjectList)>/at.bestsolution.drawswf.menu.DrawToolsMenu.<init>/0	<at.bestsolution.drawswf.menu.DrawToolsMenu: void <init>(java.lang.String,char,at.bestsolution.drawswf.DrawObjectList)>
<at.bestsolution.drawswf.DrawMenuBar: void <init>(at.bestsolution.drawswf.DrawObjectList)>/at.bestsolution.drawswf.DrawMenuBar.add/2	<javax.swing.JMenuBar: javax.swing.JMenu add(javax.swing.JMenu)>
<at.bestsolution.drawswf.DrawMenuBar: void <init>(at.bestsolution.drawswf.DrawObjectList)>/at.bestsolution.drawswf.MainWindow.getI18n/6	<at.bestsolution.drawswf.MainWindow: java.util.ResourceBundle getI18n()>
<at.bestsolution.drawswf.DrawMenuBar: void <init>(at.bestsolution.drawswf.DrawObjectList)>/at.bestsolution.drawswf.MainWindow.getI18n/7	<at.bestsolution.drawswf.MainWindow: java.util.ResourceBundle getI18n()>
<at.bestsolution.drawswf.DrawMenuBar: void <init>(at.bestsolution.drawswf.DrawObjectList)>/at.bestsolution.drawswf.menu.DrawMovieMenu.<init>/0	<at.bestsolution.drawswf.menu.DrawMovieMenu: void <init>(java.lang.String,char)>
<at.bestsolution.drawswf.DrawMenuBar: void <init>(at.bestsolution.drawswf.DrawObjectList)>/at.bestsolution.drawswf.DrawMenuBar.add/3	<javax.swing.JMenuBar: javax.swing.JMenu add(javax.swing.JMenu)>
<at.bestsolution.drawswf.DrawMenuBar: void <init>(at.bestsolution.drawswf.DrawObjectList)>/at.bestsolution.drawswf.MainWindow.getI18n/8	<at.bestsolution.drawswf.MainWindow: java.util.ResourceBundle getI18n()>
<at.bestsolution.drawswf.DrawMenuBar: void <init>(at.bestsolution.drawswf.DrawObjectList)>/at.bestsolution.drawswf.MainWindow.getI18n/9	<at.bestsolution.drawswf.MainWindow: java.util.ResourceBundle getI18n()>
<at.bestsolution.drawswf.DrawMenuBar: void <init>(at.bestsolution.drawswf.DrawObjectList)>/at.bestsolution.drawswf.menu.DrawHelpMenu.<init>/0	<at.bestsolution.drawswf.menu.DrawHelpMenu: void <init>(java.lang.String,char)>
<at.bestsolution.drawswf.DrawMenuBar: void <init>(at.bestsolution.drawswf.DrawObjectList)>/at.bestsolution.drawswf.DrawMenuBar.add/4	<javax.swing.JMenuBar: javax.swing.JMenu add(javax.swing.JMenu)>
<at.bestsolution.drawswf.DrawObjectList: void <init>(at.bestsolution.drawswf.MainWindow)>/at.bestsolution.drawswf.MainWindow.getI18n/0	<at.bestsolution.drawswf.MainWindow: java.util.ResourceBundle getI18n()>
<at.bestsolution.drawswf.DrawObjectList: void <init>(at.bestsolution.drawswf.MainWindow)>/javax.swing.JDialog.<init>/0	<javax.swing.JDialog: void <init>(java.awt.Frame,java.lang.String)>
<at.bestsolution.drawswf.DrawObjectList: void <init>(at.bestsolution.drawswf.MainWindow)>/at.bestsolution.drawswf.DrawObjectList.addComponents/0	<at.bestsolution.drawswf.DrawObjectList: void addComponents()>
<at.bestsolution.drawswf.DrawObjectList: void <init>(at.bestsolution.drawswf.MainWindow)>/at.bestsolution.drawswf.DrawObjectList.setSize/0	<java.awt.Component: void setSize(int,int)>
<at.bestsolution.drawswf.DrawObjectList: void addComponents()>/javax.swing.DefaultListModel.<init>/0	<javax.swing.DefaultListModel: void <init>()>
<at.bestsolution.drawswf.DrawObjectList: void addComponents()>/javax.swing.JList.<init>/0	<javax.swing.JList: void <init>(javax.swing.ListModel)>
<at.bestsolution.drawswf.DrawObjectList: void addComponents()>/javax.swing.JList.addListSelectionListener/0	<javax.swing.JList: void addListSelectionListener(javax.swing.event.ListSelectionListener)>
<at.bestsolution.drawswf.DrawObjectList: void addComponents()>/javax.swing.JScrollPane.<init>/0	<javax.swing.JScrollPane: void <init>()>
<at.bestsolution.drawswf.DrawObjectList: void addComponents()>/java.awt.BorderLayout.<init>/0	<java.awt.BorderLayout: void <init>()>
<at.bestsolution.drawswf.DrawObjectList: void addComponents()>/javax.swing.JPanel.<init>/0	<javax.swing.JPanel: void <init>(java.awt.LayoutManager)>
<at.bestsolution.drawswf.DrawObjectList: void addComponents()>/javax.swing.JScrollPane.setViewportView/0	<javax.swing.JScrollPane: void setViewportView(java.awt.Component)>
<at.bestsolution.drawswf.DrawObjectList: void addComponents()>/java.awt.Dimension.<init>/0	<java.awt.Dimension: void <init>(int,int)>
<at.bestsolution.drawswf.DrawObjectList: void addComponents()>/javax.swing.JScrollPane.setMinimumSize/0	<javax.swing.JComponent: void setMinimumSize(java.awt.Dimension)>
<at.bestsolution.drawswf.DrawObjectList: void addComponents()>/javax.swing.JPanel.add/0	<java.awt.Container: void add(java.awt.Component,java.lang.Object)>
<at.bestsolution.drawswf.DrawObjectList: void addComponents()>/java.awt.GridLayout.<init>/0	<java.awt.GridLayout: void <init>(int,int,int,int)>
<at.bestsolution.drawswf.DrawObjectList: void addComponents()>/javax.swing.JPanel.<init>/1	<javax.swing.JPanel: void <init>(java.awt.LayoutManager)>
<at.bestsolution.drawswf.DrawObjectList: void addComponents()>/java.lang.Object.getClass/0	<java.lang.Object: java.lang.Class getClass()>
<at.bestsolution.drawswf.DrawObjectList: void addComponents()>/java.lang.Class.getClassLoader/0	<java.lang.Class: java.lang.ClassLoader getClassLoader()>
<at.bestsolution.drawswf.DrawObjectList: void addComponents()>/javax.swing.ImageIcon.<init>/0	<javax.swing.ImageIcon: void <init>(java.net.URL)>
<at.bestsolution.drawswf.DrawObjectList: void addComponents()>/javax.swing.JButton.<init>/0	<javax.swing.JButton: void <init>(javax.swing.Icon)>
<at.bestsolution.drawswf.DrawObjectList: void addComponents()>/javax.swing.JButton.setActionCommand/0	<javax.swing.AbstractButton: void setActionCommand(java.lang.String)>
<at.bestsolution.drawswf.DrawObjectList: void addComponents()>/javax.swing.JButton.addActionListener/0	<javax.swing.AbstractButton: void addActionListener(java.awt.event.ActionListener)>
<at.bestsolution.drawswf.DrawObjectList: void addComponents()>/javax.swing.JPanel.add/1	<java.awt.Container: java.awt.Component add(java.awt.Component)>
<at.bestsolution.drawswf.DrawObjectList: void addComponents()>/java.lang.Object.getClass/1	<java.lang.Object: java.lang.Class getClass()>
<at.bestsolution.drawswf.DrawObjectList: void addComponents()>/java.lang.Class.getClassLoader/1	<java.lang.Class: java.lang.ClassLoader getClassLoader()>
<at.bestsolution.drawswf.DrawObjectList: void addComponents()>/javax.swing.ImageIcon.<init>/1	<javax.swing.ImageIcon: void <init>(java.net.URL)>
<at.bestsolution.drawswf.DrawObjectList: void addComponents()>/javax.swing.JButton.<init>/1	<javax.swing.JButton: void <init>(javax.swing.Icon)>
<at.bestsolution.drawswf.DrawObjectList: void addComponents()>/javax.swing.JButton.setActionCommand/1	<javax.swing.AbstractButton: void setActionCommand(java.lang.String)>
<at.bestsolution.drawswf.DrawObjectList: void addComponents()>/javax.swing.JButton.addActionListener/1	<javax.swing.AbstractButton: void addActionListener(java.awt.event.ActionListener)>
<at.bestsolution.drawswf.DrawObjectList: void addComponents()>/javax.swing.JPanel.add/2	<java.awt.Container: java.awt.Component add(java.awt.Component)>
<at.bestsolution.drawswf.DrawObjectList: void addComponents()>/java.lang.Object.getClass/2	<java.lang.Object: java.lang.Class getClass()>
<at.bestsolution.drawswf.DrawObjectList: void addComponents()>/java.lang.Class.getClassLoader/2	<java.lang.Class: java.lang.ClassLoader getClassLoader()>
<at.bestsolution.drawswf.DrawObjectList: void addComponents()>/javax.swing.ImageIcon.<init>/2	<javax.swing.ImageIcon: void <init>(java.net.URL)>
<at.bestsolution.drawswf.DrawObjectList: void addComponents()>/javax.swing.JButton.<init>/2	<javax.swing.JButton: void <init>(javax.swing.Icon)>
<at.bestsolution.drawswf.DrawObjectList: void addComponents()>/javax.swing.JButton.setActionCommand/2	<javax.swing.AbstractButton: void setActionCommand(java.lang.String)>
<at.bestsolution.drawswf.DrawObjectList: void addComponents()>/javax.swing.JButton.addActionListener/2	<javax.swing.AbstractButton: void addActionListener(java.awt.event.ActionListener)>
<at.bestsolution.drawswf.DrawObjectList: void addComponents()>/javax.swing.JPanel.add/3	<java.awt.Container: java.awt.Component add(java.awt.Component)>
<at.bestsolution.drawswf.DrawObjectList: void addComponents()>/javax.swing.JPanel.add/4	<java.awt.Container: void add(java.awt.Component,java.lang.Object)>
<at.bestsolution.drawswf.DrawObjectList: void addComponents()>/javax.swing.JScrollPane.<init>/1	<javax.swing.JScrollPane: void <init>()>
<at.bestsolution.drawswf.DrawObjectList: void addComponents()>/java.awt.Dimension.<init>/1	<java.awt.Dimension: void <init>(int,int)>
<at.bestsolution.drawswf.DrawObjectList: void addComponents()>/javax.swing.JScrollPane.setMinimumSize/1	<javax.swing.JComponent: void setMinimumSize(java.awt.Dimension)>
<at.bestsolution.drawswf.DrawObjectList: void addComponents()>/javax.swing.JSplitPane.<init>/0	<javax.swing.JSplitPane: void <init>(int,java.awt.Component,java.awt.Component)>
<at.bestsolution.drawswf.DrawObjectList: void addComponents()>/javax.swing.JSplitPane.setDividerLocation/0	<javax.swing.JSplitPane: void setDividerLocation(int)>
<at.bestsolution.drawswf.DrawObjectList: void addComponents()>/at.bestsolution.drawswf.DrawObjectList.getContentPane/0	<javax.swing.JDialog: java.awt.Container getContentPane()>
<at.bestsolution.drawswf.DrawToolBar: void <init>(at.bestsolution.drawswf.DrawObjectList)>/javax.swing.JToolBar.<init>/0	<javax.swing.JToolBar: void <init>()>
<at.bestsolution.drawswf.DrawToolBar: void <init>(at.bestsolution.drawswf.DrawObjectList)>/javax.swing.BorderFactory.createRaisedBevelBorder/0	<javax.swing.BorderFactory: javax.swing.border.Border createRaisedBevelBorder()>
<at.bestsolution.drawswf.DrawToolBar: void <init>(at.bestsolution.drawswf.DrawObjectList)>/at.bestsolution.drawswf.DrawToolBar.setBorder/0	<javax.swing.JComponent: void setBorder(javax.swing.border.Border)>
<at.bestsolution.drawswf.DrawToolBar: void <init>(at.bestsolution.drawswf.DrawObjectList)>/at.bestsolution.drawswf.toolbar.DrawFileToolbar.<init>/0	<at.bestsolution.drawswf.toolbar.DrawFileToolbar: void <init>()>
<at.bestsolution.drawswf.DrawToolBar: void <init>(at.bestsolution.drawswf.DrawObjectList)>/at.bestsolution.drawswf.DrawToolBar.add/0	<java.awt.Container: java.awt.Component add(java.awt.Component)>
<at.bestsolution.drawswf.DrawToolBar: void <init>(at.bestsolution.drawswf.DrawObjectList)>/at.bestsolution.drawswf.toolbar.DrawEditToolbar.<init>/0	<at.bestsolution.drawswf.toolbar.DrawEditToolbar: void <init>()>
<at.bestsolution.drawswf.DrawToolBar: void <init>(at.bestsolution.drawswf.DrawObjectList)>/at.bestsolution.drawswf.DrawToolBar.add/1	<java.awt.Container: java.awt.Component add(java.awt.Component)>
<at.bestsolution.drawswf.DrawToolBar: void <init>(at.bestsolution.drawswf.DrawObjectList)>/at.bestsolution.drawswf.toolbar.DrawToolsToolbar.<init>/0	<at.bestsolution.drawswf.toolbar.DrawToolsToolbar: void <init>()>
<at.bestsolution.drawswf.DrawToolBar: void <init>(at.bestsolution.drawswf.DrawObjectList)>/at.bestsolution.drawswf.DrawToolBar.add/2	<java.awt.Container: java.awt.Component add(java.awt.Component)>
<at.bestsolution.drawswf.DrawToolBar: void <init>(at.bestsolution.drawswf.DrawObjectList)>/at.bestsolution.drawswf.toolbar.DrawMovieToolbar.<init>/0	<at.bestsolution.drawswf.toolbar.DrawMovieToolbar: void <init>()>
<at.bestsolution.drawswf.DrawToolBar: void <init>(at.bestsolution.drawswf.DrawObjectList)>/at.bestsolution.drawswf.DrawToolBar.add/3	<java.awt.Container: java.awt.Component add(java.awt.Component)>
<at.bestsolution.drawswf.DrawingPanel: void <init>(java.awt.Dimension,at.bestsolution.drawswf.DrawObjectList)>/javax.swing.JPanel.<init>/0	<javax.swing.JPanel: void <init>()>
<at.bestsolution.drawswf.DrawingPanel: void <init>(java.awt.Dimension,at.bestsolution.drawswf.DrawObjectList)>/at.bestsolution.drawswf.DrawingPanel.setMinimumSize/0	<javax.swing.JComponent: void setMinimumSize(java.awt.Dimension)>
<at.bestsolution.drawswf.DrawingPanel: void <init>(java.awt.Dimension,at.bestsolution.drawswf.DrawObjectList)>/at.bestsolution.drawswf.DrawingPanel.setPreferredSize/0	<javax.swing.JComponent: void setPreferredSize(java.awt.Dimension)>
<at.bestsolution.drawswf.DrawingPanel: void <init>(java.awt.Dimension,at.bestsolution.drawswf.DrawObjectList)>/at.bestsolution.drawswf.DrawingPanel.setSize/0	<java.awt.Component: void setSize(java.awt.Dimension)>
<at.bestsolution.drawswf.DrawingPanel: void <init>(java.awt.Dimension,at.bestsolution.drawswf.DrawObjectList)>/java.awt.BasicStroke.<init>/0	<java.awt.BasicStroke: void <init>(float,int,int)>
<at.bestsolution.drawswf.DrawingPanel: void <init>(java.awt.Dimension,at.bestsolution.drawswf.DrawObjectList)>/java.util.LinkedList.<init>/0	<java.util.LinkedList: void <init>()>
<at.bestsolution.drawswf.DrawingPanel: void <init>(java.awt.Dimension,at.bestsolution.drawswf.DrawObjectList)>/java.util.LinkedList.<init>/1	<java.util.LinkedList: void <init>()>
<at.bestsolution.drawswf.DrawingPanel: void <init>(java.awt.Dimension,at.bestsolution.drawswf.DrawObjectList)>/at.bestsolution.drawswf.DrawingPanel.addMouseListener/0	<java.awt.Component: void addMouseListener(java.awt.event.MouseListener)>
<at.bestsolution.drawswf.DrawingPanel: void <init>(java.awt.Dimension,at.bestsolution.drawswf.DrawObjectList)>/at.bestsolution.drawswf.DrawingPanel.addMouseMotionListener/0	<java.awt.Component: void addMouseMotionListener(java.awt.event.MouseMotionListener)>
<at.bestsolution.drawswf.IconProvider: at.bestsolution.drawswf.IconProvider getInstance()>/at.bestsolution.drawswf.IconProvider.<init>/0	<at.bestsolution.drawswf.IconProvider: void <init>()>
<at.bestsolution.drawswf.IconProvider: at.bestsolution.ext.swing.icon.SolidColoredIcon getSolidColorIcon(java.lang.String)>/java.util.HashMap.get/0	<java.util.HashMap: java.lang.Object get(java.lang.Object)>
<at.bestsolution.drawswf.IconProvider: void <clinit>()>/java.util.HashMap.<init>/0	<java.util.HashMap: void <init>()>
<at.bestsolution.drawswf.IconProvider: void <clinit>()>/java.util.HashMap.<init>/1	<java.util.HashMap: void <init>()>
<at.bestsolution.drawswf.IconProvider: void <init>()>/java.lang.Object.<init>/0	<java.lang.Object: void <init>()>
<at.bestsolution.drawswf.IconProvider: void <init>()>/at.bestsolution.ext.swing.icon.SolidColoredIcon.<init>/0	<at.bestsolution.ext.swing.icon.SolidColoredIcon: void <init>(java.awt.Color,int,int,int,int)>
<at.bestsolution.drawswf.IconProvider: void <init>()>/java.util.HashMap.put/0	<java.util.HashMap: java.lang.Object put(java.lang.Object,java.lang.Object)>
<at.bestsolution.drawswf.IconProvider: void <init>()>/at.bestsolution.ext.swing.icon.SolidColoredIcon.<init>/1	<at.bestsolution.ext.swing.icon.SolidColoredIcon: void <init>(java.awt.Color,int,int,int,int)>
<at.bestsolution.drawswf.IconProvider: void <init>()>/java.util.HashMap.put/1	<java.util.HashMap: java.lang.Object put(java.lang.Object,java.lang.Object)>
<at.bestsolution.drawswf.IconProvider: void <init>()>/at.bestsolution.ext.swing.icon.SolidColoredIcon.<init>/2	<at.bestsolution.ext.swing.icon.SolidColoredIcon: void <init>(java.awt.Color,int,int,int,int)>
<at.bestsolution.drawswf.IconProvider: void <init>()>/java.util.HashMap.put/2	<java.util.HashMap: java.lang.Object put(java.lang.Object,java.lang.Object)>
<at.bestsolution.drawswf.IconProvider: void <init>()>/org.apache.batik.ext.awt.LinearGradientPaint.<init>/0	<org.apache.batik.ext.awt.LinearGradientPaint: void <init>(java.awt.geom.Point2D,java.awt.geom.Point2D,float[],java.awt.Color[],org.apache.batik.ext.awt.MultipleGradientPaint$CycleMethodEnum,org.apache.batik.ext.awt.MultipleGradientPaint$ColorSpaceEnum)>
<at.bestsolution.drawswf.IconProvider: void <init>()>/at.bestsolution.ext.swing.icon.GradientIcon.<init>/0	<at.bestsolution.ext.swing.icon.GradientIcon: void <init>(org.apache.batik.ext.awt.MultipleGradientPaint,int,int,int,int)>
<at.bestsolution.drawswf.IconProvider: void <init>()>/java.util.HashMap.put/3	<java.util.HashMap: java.lang.Object put(java.lang.Object,java.lang.Object)>
<at.bestsolution.drawswf.MainWindow$1: void <init>(at.bestsolution.drawswf.MainWindow)>/java.awt.event.WindowAdapter.<init>/0	<java.awt.event.WindowAdapter: void <init>()>
<at.bestsolution.drawswf.MainWindow: void <init>()>/javax.swing.JFrame.<init>/0	<javax.swing.JFrame: void <init>(java.lang.String)>
<at.bestsolution.drawswf.MainWindow: void drawIt(at.bestsolution.drawswf.SplashScreen)>/at.bestsolution.drawswf.MainWindow.setI18n/0	<at.bestsolution.drawswf.MainWindow: void setI18n()>
<at.bestsolution.drawswf.MainWindow: void drawIt(at.bestsolution.drawswf.SplashScreen)>/at.bestsolution.drawswf.SplashScreen.progress/0	<at.bestsolution.drawswf.SplashScreen: void progress(int)>
<at.bestsolution.drawswf.MainWindow: void drawIt(at.bestsolution.drawswf.SplashScreen)>/at.bestsolution.drawswf.MainWindow.setIcon/0	<at.bestsolution.drawswf.MainWindow: void setIcon()>
<at.bestsolution.drawswf.MainWindow: void drawIt(at.bestsolution.drawswf.SplashScreen)>/at.bestsolution.drawswf.SplashScreen.progress/1	<at.bestsolution.drawswf.SplashScreen: void progress(int)>
<at.bestsolution.drawswf.MainWindow: void drawIt(at.bestsolution.drawswf.SplashScreen)>/at.bestsolution.drawswf.MainWindow$1.<init>/0	<at.bestsolution.drawswf.MainWindow$1: void <init>(at.bestsolution.drawswf.MainWindow)>
<at.bestsolution.drawswf.MainWindow: void drawIt(at.bestsolution.drawswf.SplashScreen)>/at.bestsolution.drawswf.MainWindow.addWindowListener/0	<java.awt.Window: void addWindowListener(java.awt.event.WindowListener)>
<at.bestsolution.drawswf.MainWindow: void drawIt(at.bestsolution.drawswf.SplashScreen)>/at.bestsolution.drawswf.SplashScreen.progress/2	<at.bestsolution.drawswf.SplashScreen: void progress(int)>
<at.bestsolution.drawswf.MainWindow: void drawIt(at.bestsolution.drawswf.SplashScreen)>/at.bestsolution.drawswf.DrawObjectList.<init>/0	<at.bestsolution.drawswf.DrawObjectList: void <init>(at.bestsolution.drawswf.MainWindow)>
<at.bestsolution.drawswf.MainWindow: void drawIt(at.bestsolution.drawswf.SplashScreen)>/at.bestsolution.drawswf.SplashScreen.progress/3	<at.bestsolution.drawswf.SplashScreen: void progress(int)>
<at.bestsolution.drawswf.MainWindow: void drawIt(at.bestsolution.drawswf.SplashScreen)>/java.awt.Dimension.<init>/0	<java.awt.Dimension: void <init>(int,int)>
<at.bestsolution.drawswf.MainWindow: void drawIt(at.bestsolution.drawswf.SplashScreen)>/at.bestsolution.drawswf.DrawingPanel.<init>/0	<at.bestsolution.drawswf.DrawingPanel: void <init>(java.awt.Dimension,at.bestsolution.drawswf.DrawObjectList)>
<at.bestsolution.drawswf.MainWindow: void drawIt(at.bestsolution.drawswf.SplashScreen)>/at.bestsolution.drawswf.MainWindow.getContentPane/0	<javax.swing.JFrame: java.awt.Container getContentPane()>
<at.bestsolution.drawswf.MainWindow: void drawIt(at.bestsolution.drawswf.SplashScreen)>/at.bestsolution.drawswf.SplashScreen.progress/4	<at.bestsolution.drawswf.SplashScreen: void progress(int)>
<at.bestsolution.drawswf.MainWindow: void drawIt(at.bestsolution.drawswf.SplashScreen)>/at.bestsolution.drawswf.DrawMenuBar.<init>/0	<at.bestsolution.drawswf.DrawMenuBar: void <init>(at.bestsolution.drawswf.DrawObjectList)>
<at.bestsolution.drawswf.MainWindow: void drawIt(at.bestsolution.drawswf.SplashScreen)>/at.bestsolution.drawswf.DrawToolBar.<init>/0	<at.bestsolution.drawswf.DrawToolBar: void <init>(at.bestsolution.drawswf.DrawObjectList)>
<at.bestsolution.drawswf.MainWindow: void drawIt(at.bestsolution.drawswf.SplashScreen)>/at.bestsolution.drawswf.MainWindow.setJMenuBar/0	<javax.swing.JFrame: void setJMenuBar(javax.swing.JMenuBar)>
<at.bestsolution.drawswf.MainWindow: void drawIt(at.bestsolution.drawswf.SplashScreen)>/at.bestsolution.drawswf.MainWindow.getContentPane/1	<javax.swing.JFrame: java.awt.Container getContentPane()>
<at.bestsolution.drawswf.MainWindow: void drawIt(at.bestsolution.drawswf.SplashScreen)>/at.bestsolution.drawswf.SplashScreen.progress/5	<at.bestsolution.drawswf.SplashScreen: void progress(int)>
<at.bestsolution.drawswf.MainWindow: void drawIt(at.bestsolution.drawswf.SplashScreen)>/at.bestsolution.drawswf.MainWindow.pack/0	<java.awt.Window: void pack()>
<at.bestsolution.drawswf.MainWindow: void drawIt(at.bestsolution.drawswf.SplashScreen)>/at.bestsolution.drawswf.SplashScreen.progress/6	<at.bestsolution.drawswf.SplashScreen: void progress(int)>
<at.bestsolution.drawswf.MainWindow: void drawIt(at.bestsolution.drawswf.SplashScreen)>/at.bestsolution.drawswf.MainWindow.setFrameToCenter/0	<at.bestsolution.drawswf.MainWindow: void setFrameToCenter()>
<at.bestsolution.drawswf.MainWindow: void drawIt(at.bestsolution.drawswf.SplashScreen)>/at.bestsolution.drawswf.SplashScreen.progress/7	<at.bestsolution.drawswf.SplashScreen: void progress(int)>
<at.bestsolution.drawswf.MainWindow: void drawIt(at.bestsolution.drawswf.SplashScreen)>/at.bestsolution.drawswf.DrawObjectList.show/0	<java.awt.Dialog: void show()>
<at.bestsolution.drawswf.MainWindow: void drawIt(at.bestsolution.drawswf.SplashScreen)>/at.bestsolution.drawswf.PluginLoader.<init>/0	<at.bestsolution.drawswf.PluginLoader: void <init>()>
<at.bestsolution.drawswf.MainWindow: void drawIt(at.bestsolution.drawswf.SplashScreen)>/at.bestsolution.drawswf.PluginLoader.loadPlugins/0	<at.bestsolution.drawswf.PluginLoader: java.util.ArrayList loadPlugins()>
<at.bestsolution.drawswf.MainWindow: void drawIt(at.bestsolution.drawswf.SplashScreen)>/at.bestsolution.ext.awt.FontLoader.getInstance/0	<at.bestsolution.ext.awt.FontLoader: at.bestsolution.ext.awt.FontLoader getInstance()>
<at.bestsolution.drawswf.MainWindow: void drawIt(at.bestsolution.drawswf.SplashScreen)>/at.bestsolution.drawswf.util.DrawSWFConfig.getInstance/0	<at.bestsolution.drawswf.util.DrawSWFConfig: at.bestsolution.drawswf.util.DrawSWFConfig getInstance()>
<at.bestsolution.drawswf.MainWindow: void drawIt(at.bestsolution.drawswf.SplashScreen)>/at.bestsolution.drawswf.util.DrawSWFConfig.getProperty/0	<at.bestsolution.util.BestsolutionConfiguration: java.lang.String getProperty(java.lang.String)>
<at.bestsolution.drawswf.MainWindow: void drawIt(at.bestsolution.drawswf.SplashScreen)>/at.bestsolution.ext.awt.FontLoader.addAdditionalPath/0	<at.bestsolution.ext.awt.FontLoader: void addAdditionalPath(java.lang.String)>
<at.bestsolution.drawswf.MainWindow: void drawIt(at.bestsolution.drawswf.SplashScreen)>/at.bestsolution.drawswf.SplashScreen.progress/8	<at.bestsolution.drawswf.SplashScreen: void progress(int)>
<at.bestsolution.drawswf.MainWindow: void setFrameToCenter()>/java.awt.Toolkit.getDefaultToolkit/0	<java.awt.Toolkit: java.awt.Toolkit getDefaultToolkit()>
<at.bestsolution.drawswf.MainWindow: void setFrameToCenter()>/at.bestsolution.drawswf.MainWindow.getSize/0	<java.awt.Component: java.awt.Dimension getSize()>
<at.bestsolution.drawswf.MainWindow: void setFrameToCenter()>/at.bestsolution.drawswf.MainWindow.setLocation/0	<java.awt.Component: void setLocation(int,int)>
<at.bestsolution.drawswf.MainWindow: void setFrameToCenter()>/at.bestsolution.drawswf.DrawObjectList.getWidth/0	<java.awt.Component: int getWidth()>
<at.bestsolution.drawswf.MainWindow: void setFrameToCenter()>/at.bestsolution.drawswf.DrawObjectList.setLocation/0	<java.awt.Component: void setLocation(int,int)>
<at.bestsolution.drawswf.MainWindow: void setI18n()>/at.bestsolution.drawswf.util.DrawSWFConfig.getInstance/0	<at.bestsolution.drawswf.util.DrawSWFConfig: at.bestsolution.drawswf.util.DrawSWFConfig getInstance()>
<at.bestsolution.drawswf.MainWindow: void setI18n()>/at.bestsolution.drawswf.util.DrawSWFConfig.getProperty/0	<at.bestsolution.util.BestsolutionConfiguration: java.lang.String getProperty(java.lang.String)>
<at.bestsolution.drawswf.MainWindow: void setI18n()>/java.lang.StringBuffer.<init>/0	<java.lang.StringBuffer: void <init>()>
<at.bestsolution.drawswf.MainWindow: void setI18n()>/java.lang.System.getProperty/0	<java.lang.System: java.lang.String getProperty(java.lang.String)>
<at.bestsolution.drawswf.MainWindow: void setI18n()>/java.lang.StringBuffer.append/0	<java.lang.StringBuffer: java.lang.StringBuffer append(java.lang.String)>
<at.bestsolution.drawswf.MainWindow: void setI18n()>/at.bestsolution.drawswf.util.DrawSWFConfig.setProperty/0	<at.bestsolution.util.BestsolutionConfiguration: void setProperty(java.lang.String,java.lang.String)>
<at.bestsolution.drawswf.MainWindow: void setI18n()>/java.io.File.<init>/0	<java.io.File: void <init>(java.lang.String)>
<at.bestsolution.drawswf.MainWindow: void setI18n()>/java.io.File.exists/0	<java.io.File: boolean exists()>
<at.bestsolution.drawswf.MainWindow: void setI18n()>/java.io.File.mkdirs/0	<java.io.File: boolean mkdirs()>
<at.bestsolution.drawswf.MainWindow: void setI18n()>/at.bestsolution.drawswf.util.DrawSWFConfig.save/0	<at.bestsolution.util.BestsolutionConfiguration: void save()>
<at.bestsolution.drawswf.MainWindow: void setI18n()>/at.bestsolution.drawswf.util.DrawSWFConfig.getProperty/1	<at.bestsolution.util.BestsolutionConfiguration: java.lang.String getProperty(java.lang.String)>
<at.bestsolution.drawswf.MainWindow: void setI18n()>/java.util.Locale.<init>/0	<java.util.Locale: void <init>(java.lang.String)>
<at.bestsolution.drawswf.MainWindow: void setI18n()>/java.util.ResourceBundle.getBundle/0	<java.util.ResourceBundle: java.util.ResourceBundle getBundle(java.lang.String,java.util.Locale)>
<at.bestsolution.drawswf.MainWindow: void setIcon()>/java.lang.Object.getClass/0	<java.lang.Object: java.lang.Class getClass()>
<at.bestsolution.drawswf.MainWindow: void setIcon()>/java.lang.Class.getClassLoader/0	<java.lang.Class: java.lang.ClassLoader getClassLoader()>
<at.bestsolution.drawswf.MainWindow: void setIcon()>/java.awt.Toolkit.getDefaultToolkit/0	<java.awt.Toolkit: java.awt.Toolkit getDefaultToolkit()>
<at.bestsolution.drawswf.MainWindow: void setIcon()>/at.bestsolution.drawswf.MainWindow.setIconImage/0	<java.awt.Frame: void setIconImage(java.awt.Image)>
<at.bestsolution.drawswf.PluginLoader: java.util.ArrayList loadPlugins()>/java.util.ArrayList.<init>/0	<java.util.ArrayList: void <init>()>
<at.bestsolution.drawswf.PluginLoader: java.util.ArrayList loadPlugins()>/at.bestsolution.drawswf.util.DrawSWFConfig.getInstance/0	<at.bestsolution.drawswf.util.DrawSWFConfig: at.bestsolution.drawswf.util.DrawSWFConfig getInstance()>
<at.bestsolution.drawswf.PluginLoader: java.util.ArrayList loadPlugins()>/at.bestsolution.drawswf.util.DrawSWFConfig.getProperty/0	<at.bestsolution.util.BestsolutionConfiguration: java.lang.String getProperty(java.lang.String)>
<at.bestsolution.drawswf.PluginLoader: java.util.ArrayList loadPlugins()>/at.bestsolution.util.ExtensionsClassLoader.getClassLoader/0	<at.bestsolution.util.ExtensionsClassLoader: java.lang.ClassLoader getClassLoader(java.lang.String)>
<at.bestsolution.drawswf.PluginLoader: java.util.ArrayList loadPlugins()>/at.bestsolution.util.ExtensionsClassLoader.getJars/0	<at.bestsolution.util.ExtensionsClassLoader: java.net.URL[] getJars()>
<at.bestsolution.drawswf.PluginLoader: java.util.ArrayList loadPlugins()>/at.bestsolution.util.ExtensionsClassLoader.getMainClassName/0	<at.bestsolution.util.ExtensionsClassLoader: java.lang.String getMainClassName(java.net.URL)>
<at.bestsolution.drawswf.PluginLoader: java.util.ArrayList loadPlugins()>/at.bestsolution.util.ExtensionsClassLoader.getMainClassName/1	<at.bestsolution.util.ExtensionsClassLoader: java.lang.String getMainClassName(java.net.URL)>
<at.bestsolution.drawswf.PluginLoader: java.util.ArrayList loadPlugins()>/at.bestsolution.drawswf.MainWindow.getDrawingPanel/0	<at.bestsolution.drawswf.MainWindow: at.bestsolution.drawswf.DrawingPanel getDrawingPanel()>
<at.bestsolution.drawswf.PluginLoader: java.util.ArrayList loadPlugins()>/java.util.ArrayList.add/0	<java.util.ArrayList: boolean add(java.lang.Object)>
<at.bestsolution.drawswf.PluginLoader: java.util.ArrayList loadPlugins()>/java.lang.StringBuffer.<init>/0	<java.lang.StringBuffer: void <init>()>
<at.bestsolution.drawswf.PluginLoader: java.util.ArrayList loadPlugins()>/java.lang.StringBuffer.append/0	<java.lang.StringBuffer: java.lang.StringBuffer append(java.lang.String)>
<at.bestsolution.drawswf.PluginLoader: void <init>()>/java.lang.Object.<init>/0	<java.lang.Object: void <init>()>
<at.bestsolution.drawswf.SplashScreen$1: void <init>(at.bestsolution.drawswf.SplashScreen)>/java.awt.event.MouseAdapter.<init>/0	<java.awt.event.MouseAdapter: void <init>()>
<at.bestsolution.drawswf.SplashScreen$2: void <init>(at.bestsolution.drawswf.SplashScreen)>/java.lang.Object.<init>/0	<java.lang.Object: void <init>()>
<at.bestsolution.drawswf.SplashScreen$3: void <init>(at.bestsolution.drawswf.SplashScreen,int,java.lang.Runnable)>/java.lang.Object.<init>/0	<java.lang.Object: void <init>()>
<at.bestsolution.drawswf.SplashScreen: void <init>(javax.swing.JFrame,int)>/javax.swing.JWindow.<init>/0	<javax.swing.JWindow: void <init>(java.awt.Frame)>
<at.bestsolution.drawswf.SplashScreen: void <init>(javax.swing.JFrame,int)>/javax.swing.JPanel.<init>/0	<javax.swing.JPanel: void <init>()>
<at.bestsolution.drawswf.SplashScreen: void <init>(javax.swing.JFrame,int)>/at.bestsolution.drawswf.SplashScreen.getContentPane/0	<javax.swing.JWindow: java.awt.Container getContentPane()>
<at.bestsolution.drawswf.SplashScreen: void <init>(javax.swing.JFrame,int)>/javax.swing.JPanel.setBackground/0	<javax.swing.JComponent: void setBackground(java.awt.Color)>
<at.bestsolution.drawswf.SplashScreen: void <init>(javax.swing.JFrame,int)>/javax.swing.BorderFactory.createEtchedBorder/0	<javax.swing.BorderFactory: javax.swing.border.Border createEtchedBorder(int)>
<at.bestsolution.drawswf.SplashScreen: void <init>(javax.swing.JFrame,int)>/javax.swing.JPanel.setBorder/0	<javax.swing.JComponent: void setBorder(javax.swing.border.Border)>
<at.bestsolution.drawswf.SplashScreen: void <init>(javax.swing.JFrame,int)>/java.awt.BorderLayout.<init>/0	<java.awt.BorderLayout: void <init>(int,int)>
<at.bestsolution.drawswf.SplashScreen: void <init>(javax.swing.JFrame,int)>/javax.swing.JPanel.setLayout/0	<java.awt.Container: void setLayout(java.awt.LayoutManager)>
<at.bestsolution.drawswf.SplashScreen: void <init>(javax.swing.JFrame,int)>/at.bestsolution.drawswf.SplashScreen.addContainers/0	<at.bestsolution.drawswf.SplashScreen: void addContainers(javax.swing.JPanel)>
<at.bestsolution.drawswf.SplashScreen: void <init>(javax.swing.JFrame,int)>/at.bestsolution.drawswf.SplashScreen.pack/0	<java.awt.Window: void pack()>
<at.bestsolution.drawswf.SplashScreen: void <init>(javax.swing.JFrame,int)>/java.awt.Toolkit.getDefaultToolkit/0	<java.awt.Toolkit: java.awt.Toolkit getDefaultToolkit()>
<at.bestsolution.drawswf.SplashScreen: void <init>(javax.swing.JFrame,int)>/at.bestsolution.drawswf.SplashScreen.getContentPane/1	<javax.swing.JWindow: java.awt.Container getContentPane()>
<at.bestsolution.drawswf.SplashScreen: void <init>(javax.swing.JFrame,int)>/at.bestsolution.drawswf.SplashScreen.setLocation/0	<java.awt.Component: void setLocation(int,int)>
<at.bestsolution.drawswf.SplashScreen: void <init>(javax.swing.JFrame,int)>/at.bestsolution.drawswf.SplashScreen.addListeners/0	<at.bestsolution.drawswf.SplashScreen: void addListeners()>
<at.bestsolution.drawswf.SplashScreen: void <init>(javax.swing.JFrame,int)>/at.bestsolution.drawswf.SplashScreen.threadIt/0	<at.bestsolution.drawswf.SplashScreen: void threadIt(int)>
<at.bestsolution.drawswf.SplashScreen: void addContainers(javax.swing.JPanel)>/javax.swing.JLabel.<init>/0	<javax.swing.JLabel: void <init>(java.lang.String)>
<at.bestsolution.drawswf.SplashScreen: void addContainers(javax.swing.JPanel)>/javax.swing.JLabel.setHorizontalAlignment/0	<javax.swing.JLabel: void setHorizontalAlignment(int)>
<at.bestsolution.drawswf.SplashScreen: void addContainers(javax.swing.JPanel)>/javax.swing.JProgressBar.<init>/0	<javax.swing.JProgressBar: void <init>(int,int)>
<at.bestsolution.drawswf.SplashScreen: void addContainers(javax.swing.JPanel)>/javax.swing.JProgressBar.setStringPainted/0	<javax.swing.JProgressBar: void setStringPainted(boolean)>
<at.bestsolution.drawswf.SplashScreen: void addContainers(javax.swing.JPanel)>/java.lang.Object.getClass/0	<java.lang.Object: java.lang.Class getClass()>
<at.bestsolution.drawswf.SplashScreen: void addContainers(javax.swing.JPanel)>/java.lang.Class.getClassLoader/0	<java.lang.Class: java.lang.ClassLoader getClassLoader()>
<at.bestsolution.drawswf.SplashScreen: void addContainers(javax.swing.JPanel)>/javax.swing.ImageIcon.<init>/0	<javax.swing.ImageIcon: void <init>(java.net.URL)>
<at.bestsolution.drawswf.SplashScreen: void addContainers(javax.swing.JPanel)>/javax.swing.JLabel.<init>/1	<javax.swing.JLabel: void <init>(javax.swing.Icon)>
<at.bestsolution.drawswf.SplashScreen: void addContainers(javax.swing.JPanel)>/javax.swing.JPanel.add/0	<java.awt.Container: void add(java.awt.Component,java.lang.Object)>
<at.bestsolution.drawswf.SplashScreen: void addContainers(javax.swing.JPanel)>/javax.swing.JPanel.add/1	<java.awt.Container: void add(java.awt.Component,java.lang.Object)>
<at.bestsolution.drawswf.SplashScreen: void addContainers(javax.swing.JPanel)>/javax.swing.JPanel.add/2	<java.awt.Container: void add(java.awt.Component,java.lang.Object)>
<at.bestsolution.drawswf.SplashScreen: void addListeners()>/at.bestsolution.drawswf.SplashScreen$1.<init>/0	<at.bestsolution.drawswf.SplashScreen$1: void <init>(at.bestsolution.drawswf.SplashScreen)>
<at.bestsolution.drawswf.SplashScreen: void addListeners()>/at.bestsolution.drawswf.SplashScreen.addMouseListener/0	<java.awt.Component: void addMouseListener(java.awt.event.MouseListener)>
<at.bestsolution.drawswf.SplashScreen: void progress(int)>/javax.swing.JProgressBar.getValue/0	<javax.swing.JProgressBar: int getValue()>
<at.bestsolution.drawswf.SplashScreen: void progress(int)>/javax.swing.JProgressBar.setValue/0	<javax.swing.JProgressBar: void setValue(int)>
<at.bestsolution.drawswf.SplashScreen: void threadIt(int)>/at.bestsolution.drawswf.SplashScreen$2.<init>/0	<at.bestsolution.drawswf.SplashScreen$2: void <init>(at.bestsolution.drawswf.SplashScreen)>
<at.bestsolution.drawswf.SplashScreen: void threadIt(int)>/at.bestsolution.drawswf.SplashScreen$3.<init>/0	<at.bestsolution.drawswf.SplashScreen$3: void <init>(at.bestsolution.drawswf.SplashScreen,int,java.lang.Runnable)>
<at.bestsolution.drawswf.SplashScreen: void threadIt(int)>/at.bestsolution.drawswf.SplashScreen.setVisible/0	<java.awt.Component: void setVisible(boolean)>
<at.bestsolution.drawswf.SplashScreen: void threadIt(int)>/java.lang.Thread.<init>/0	<java.lang.Thread: void <init>(java.lang.Runnable,java.lang.String)>
<at.bestsolution.drawswf.SplashScreen: void threadIt(int)>/java.lang.Thread.start/0	<java.lang.Thread: void start()>
<at.bestsolution.drawswf.actions.AboutAction: void <init>(java.lang.String,java.lang.String,java.lang.String,at.bestsolution.drawswf.DrawingPanel,int,javax.swing.KeyStroke)>/java.lang.StringBuffer.<init>/0	<java.lang.StringBuffer: void <init>()>
<at.bestsolution.drawswf.actions.AboutAction: void <init>(java.lang.String,java.lang.String,java.lang.String,at.bestsolution.drawswf.DrawingPanel,int,javax.swing.KeyStroke)>/java.lang.StringBuffer.append/0	<java.lang.StringBuffer: java.lang.StringBuffer append(java.lang.String)>
<at.bestsolution.drawswf.actions.AboutAction: void <init>(java.lang.String,java.lang.String,java.lang.String,at.bestsolution.drawswf.DrawingPanel,int,javax.swing.KeyStroke)>/at.bestsolution.drawswf.actions.AbstractDrawAction.<init>/0	<at.bestsolution.drawswf.actions.AbstractDrawAction: void <init>(java.lang.String,java.lang.String,java.lang.String,at.bestsolution.drawswf.DrawingPanel,int,javax.swing.KeyStroke)>
<at.bestsolution.drawswf.actions.AbstractDrawAction: void <init>(java.lang.String,java.lang.String,at.bestsolution.drawswf.DrawingPanel)>/javax.swing.AbstractAction.<init>/0	<javax.swing.AbstractAction: void <init>()>
<at.bestsolution.drawswf.actions.AbstractDrawAction: void <init>(java.lang.String,java.lang.String,at.bestsolution.drawswf.DrawingPanel)>/java.lang.Object.getClass/0	<java.lang.Object: java.lang.Class getClass()>
<at.bestsolution.drawswf.actions.AbstractDrawAction: void <init>(java.lang.String,java.lang.String,at.bestsolution.drawswf.DrawingPanel)>/java.lang.Class.getClassLoader/0	<java.lang.Class: java.lang.ClassLoader getClassLoader()>
<at.bestsolution.drawswf.actions.AbstractDrawAction: void <init>(java.lang.String,java.lang.String,at.bestsolution.drawswf.DrawingPanel)>/javax.swing.ImageIcon.<init>/0	<javax.swing.ImageIcon: void <init>(java.net.URL)>
<at.bestsolution.drawswf.actions.AbstractDrawAction: void <init>(java.lang.String,java.lang.String,at.bestsolution.drawswf.DrawingPanel)>/at.bestsolution.drawswf.actions.AbstractDrawAction.putValue/0	<javax.swing.AbstractAction: void putValue(java.lang.String,java.lang.Object)>
<at.bestsolution.drawswf.actions.AbstractDrawAction: void <init>(java.lang.String,java.lang.String,at.bestsolution.drawswf.DrawingPanel)>/at.bestsolution.drawswf.actions.AbstractDrawAction.putValue/1	<javax.swing.AbstractAction: void putValue(java.lang.String,java.lang.Object)>
<at.bestsolution.drawswf.actions.AbstractDrawAction: void <init>(java.lang.String,java.lang.String,java.lang.String,at.bestsolution.drawswf.DrawingPanel,int,javax.swing.KeyStroke)>/javax.swing.AbstractAction.<init>/0	<javax.swing.AbstractAction: void <init>()>
<at.bestsolution.drawswf.actions.AbstractDrawAction: void <init>(java.lang.String,java.lang.String,java.lang.String,at.bestsolution.drawswf.DrawingPanel,int,javax.swing.KeyStroke)>/java.lang.Object.getClass/0	<java.lang.Object: java.lang.Class getClass()>
<at.bestsolution.drawswf.actions.AbstractDrawAction: void <init>(java.lang.String,java.lang.String,java.lang.String,at.bestsolution.drawswf.DrawingPanel,int,javax.swing.KeyStroke)>/java.lang.Class.getClassLoader/0	<java.lang.Class: java.lang.ClassLoader getClassLoader()>
<at.bestsolution.drawswf.actions.AbstractDrawAction: void <init>(java.lang.String,java.lang.String,java.lang.String,at.bestsolution.drawswf.DrawingPanel,int,javax.swing.KeyStroke)>/javax.swing.ImageIcon.<init>/0	<javax.swing.ImageIcon: void <init>(java.net.URL)>
<at.bestsolution.drawswf.actions.AbstractDrawAction: void <init>(java.lang.String,java.lang.String,java.lang.String,at.bestsolution.drawswf.DrawingPanel,int,javax.swing.KeyStroke)>/at.bestsolution.drawswf.actions.AbstractDrawAction.putValue/0	<javax.swing.AbstractAction: void putValue(java.lang.String,java.lang.Object)>
<at.bestsolution.drawswf.actions.AbstractDrawAction: void <init>(java.lang.String,java.lang.String,java.lang.String,at.bestsolution.drawswf.DrawingPanel,int,javax.swing.KeyStroke)>/at.bestsolution.drawswf.actions.AbstractDrawAction.putValue/1	<javax.swing.AbstractAction: void putValue(java.lang.String,java.lang.Object)>
<at.bestsolution.drawswf.actions.AbstractDrawAction: void <init>(java.lang.String,java.lang.String,java.lang.String,at.bestsolution.drawswf.DrawingPanel,int,javax.swing.KeyStroke)>/at.bestsolution.drawswf.actions.AbstractDrawAction.putValue/2	<javax.swing.AbstractAction: void putValue(java.lang.String,java.lang.Object)>
<at.bestsolution.drawswf.actions.AbstractDrawAction: void <init>(java.lang.String,java.lang.String,java.lang.String,at.bestsolution.drawswf.DrawingPanel,int,javax.swing.KeyStroke)>/java.lang.Integer.<init>/0	<java.lang.Integer: void <init>(int)>
<at.bestsolution.drawswf.actions.AbstractDrawAction: void <init>(java.lang.String,java.lang.String,java.lang.String,at.bestsolution.drawswf.DrawingPanel,int,javax.swing.KeyStroke)>/at.bestsolution.drawswf.actions.AbstractDrawAction.putValue/3	<javax.swing.AbstractAction: void putValue(java.lang.String,java.lang.Object)>
<at.bestsolution.drawswf.actions.AbstractDrawAction: void <init>(java.lang.String,java.lang.String,java.lang.String,at.bestsolution.drawswf.DrawingPanel,int,javax.swing.KeyStroke)>/at.bestsolution.drawswf.actions.AbstractDrawAction.putValue/4	<javax.swing.AbstractAction: void putValue(java.lang.String,java.lang.Object)>
<at.bestsolution.drawswf.actions.ClearAction: void <init>(java.lang.String,java.lang.String,at.bestsolution.drawswf.DrawingPanel)>/java.lang.StringBuffer.<init>/0	<java.lang.StringBuffer: void <init>()>
<at.bestsolution.drawswf.actions.ClearAction: void <init>(java.lang.String,java.lang.String,at.bestsolution.drawswf.DrawingPanel)>/java.lang.StringBuffer.append/0	<java.lang.StringBuffer: java.lang.StringBuffer append(java.lang.String)>
<at.bestsolution.drawswf.actions.ClearAction: void <init>(java.lang.String,java.lang.String,at.bestsolution.drawswf.DrawingPanel)>/at.bestsolution.drawswf.actions.AbstractDrawAction.<init>/0	<at.bestsolution.drawswf.actions.AbstractDrawAction: void <init>(java.lang.String,java.lang.String,at.bestsolution.drawswf.DrawingPanel)>
<at.bestsolution.drawswf.actions.ClearAction: void <init>(java.lang.String,java.lang.String,java.lang.String,at.bestsolution.drawswf.DrawingPanel,int,javax.swing.KeyStroke)>/java.lang.StringBuffer.<init>/0	<java.lang.StringBuffer: void <init>()>
<at.bestsolution.drawswf.actions.ClearAction: void <init>(java.lang.String,java.lang.String,java.lang.String,at.bestsolution.drawswf.DrawingPanel,int,javax.swing.KeyStroke)>/java.lang.StringBuffer.append/0	<java.lang.StringBuffer: java.lang.StringBuffer append(java.lang.String)>
<at.bestsolution.drawswf.actions.ClearAction: void <init>(java.lang.String,java.lang.String,java.lang.String,at.bestsolution.drawswf.DrawingPanel,int,javax.swing.KeyStroke)>/at.bestsolution.drawswf.actions.AbstractDrawAction.<init>/0	<at.bestsolution.drawswf.actions.AbstractDrawAction: void <init>(java.lang.String,java.lang.String,java.lang.String,at.bestsolution.drawswf.DrawingPanel,int,javax.swing.KeyStroke)>
<at.bestsolution.drawswf.actions.ExitAction: void <init>(java.lang.String,java.lang.String,java.lang.String,at.bestsolution.drawswf.DrawingPanel,int,javax.swing.KeyStroke)>/java.lang.StringBuffer.<init>/0	<java.lang.StringBuffer: void <init>()>
<at.bestsolution.drawswf.actions.ExitAction: void <init>(java.lang.String,java.lang.String,java.lang.String,at.bestsolution.drawswf.DrawingPanel,int,javax.swing.KeyStroke)>/java.lang.StringBuffer.append/0	<java.lang.StringBuffer: java.lang.StringBuffer append(java.lang.String)>
<at.bestsolution.drawswf.actions.ExitAction: void <init>(java.lang.String,java.lang.String,java.lang.String,at.bestsolution.drawswf.DrawingPanel,int,javax.swing.KeyStroke)>/at.bestsolution.drawswf.actions.AbstractDrawAction.<init>/0	<at.bestsolution.drawswf.actions.AbstractDrawAction: void <init>(java.lang.String,java.lang.String,java.lang.String,at.bestsolution.drawswf.DrawingPanel,int,javax.swing.KeyStroke)>
<at.bestsolution.drawswf.actions.FileAction: void <init>(java.lang.String,java.lang.String,at.bestsolution.drawswf.DrawingPanel,boolean,boolean)>/java.lang.StringBuffer.<init>/0	<java.lang.StringBuffer: void <init>()>
<at.bestsolution.drawswf.actions.FileAction: void <init>(java.lang.String,java.lang.String,at.bestsolution.drawswf.DrawingPanel,boolean,boolean)>/java.lang.StringBuffer.append/0	<java.lang.StringBuffer: java.lang.StringBuffer append(java.lang.String)>
<at.bestsolution.drawswf.actions.FileAction: void <init>(java.lang.String,java.lang.String,at.bestsolution.drawswf.DrawingPanel,boolean,boolean)>/at.bestsolution.drawswf.actions.AbstractDrawAction.<init>/0	<at.bestsolution.drawswf.actions.AbstractDrawAction: void <init>(java.lang.String,java.lang.String,at.bestsolution.drawswf.DrawingPanel)>
<at.bestsolution.drawswf.actions.FileAction: void <init>(java.lang.String,java.lang.String,java.lang.String,at.bestsolution.drawswf.DrawingPanel,boolean,int,javax.swing.KeyStroke,boolean)>/java.lang.StringBuffer.<init>/0	<java.lang.StringBuffer: void <init>()>
<at.bestsolution.drawswf.actions.FileAction: void <init>(java.lang.String,java.lang.String,java.lang.String,at.bestsolution.drawswf.DrawingPanel,boolean,int,javax.swing.KeyStroke,boolean)>/java.lang.StringBuffer.append/0	<java.lang.StringBuffer: java.lang.StringBuffer append(java.lang.String)>
<at.bestsolution.drawswf.actions.FileAction: void <init>(java.lang.String,java.lang.String,java.lang.String,at.bestsolution.drawswf.DrawingPanel,boolean,int,javax.swing.KeyStroke,boolean)>/at.bestsolution.drawswf.actions.AbstractDrawAction.<init>/0	<at.bestsolution.drawswf.actions.AbstractDrawAction: void <init>(java.lang.String,java.lang.String,java.lang.String,at.bestsolution.drawswf.DrawingPanel,int,javax.swing.KeyStroke)>
<at.bestsolution.drawswf.actions.GraphicTemplateAction: void <init>(java.lang.String,java.lang.String,at.bestsolution.drawswf.DrawingPanel)>/java.lang.StringBuffer.<init>/0	<java.lang.StringBuffer: void <init>()>
<at.bestsolution.drawswf.actions.GraphicTemplateAction: void <init>(java.lang.String,java.lang.String,at.bestsolution.drawswf.DrawingPanel)>/java.lang.StringBuffer.append/0	<java.lang.StringBuffer: java.lang.StringBuffer append(java.lang.String)>
<at.bestsolution.drawswf.actions.GraphicTemplateAction: void <init>(java.lang.String,java.lang.String,at.bestsolution.drawswf.DrawingPanel)>/at.bestsolution.drawswf.actions.AbstractDrawAction.<init>/0	<at.bestsolution.drawswf.actions.AbstractDrawAction: void <init>(java.lang.String,java.lang.String,at.bestsolution.drawswf.DrawingPanel)>
<at.bestsolution.drawswf.actions.GraphicTemplateAction: void <init>(java.lang.String,java.lang.String,java.lang.String,at.bestsolution.drawswf.DrawingPanel,int,javax.swing.KeyStroke)>/java.lang.StringBuffer.<init>/0	<java.lang.StringBuffer: void <init>()>
<at.bestsolution.drawswf.actions.GraphicTemplateAction: void <init>(java.lang.String,java.lang.String,java.lang.String,at.bestsolution.drawswf.DrawingPanel,int,javax.swing.KeyStroke)>/java.lang.StringBuffer.append/0	<java.lang.StringBuffer: java.lang.StringBuffer append(java.lang.String)>
<at.bestsolution.drawswf.actions.GraphicTemplateAction: void <init>(java.lang.String,java.lang.String,java.lang.String,at.bestsolution.drawswf.DrawingPanel,int,javax.swing.KeyStroke)>/at.bestsolution.drawswf.actions.AbstractDrawAction.<init>/0	<at.bestsolution.drawswf.actions.AbstractDrawAction: void <init>(java.lang.String,java.lang.String,java.lang.String,at.bestsolution.drawswf.DrawingPanel,int,javax.swing.KeyStroke)>
<at.bestsolution.drawswf.actions.NewFileAction: void <init>(java.lang.String,java.lang.String,java.lang.String,at.bestsolution.drawswf.DrawingPanel,int,javax.swing.KeyStroke)>/java.lang.StringBuffer.<init>/0	<java.lang.StringBuffer: void <init>()>
<at.bestsolution.drawswf.actions.NewFileAction: void <init>(java.lang.String,java.lang.String,java.lang.String,at.bestsolution.drawswf.DrawingPanel,int,javax.swing.KeyStroke)>/java.lang.StringBuffer.append/0	<java.lang.StringBuffer: java.lang.StringBuffer append(java.lang.String)>
<at.bestsolution.drawswf.actions.NewFileAction: void <init>(java.lang.String,java.lang.String,java.lang.String,at.bestsolution.drawswf.DrawingPanel,int,javax.swing.KeyStroke)>/at.bestsolution.drawswf.actions.AbstractDrawAction.<init>/0	<at.bestsolution.drawswf.actions.AbstractDrawAction: void <init>(java.lang.String,java.lang.String,java.lang.String,at.bestsolution.drawswf.DrawingPanel,int,javax.swing.KeyStroke)>
<at.bestsolution.drawswf.actions.ObjectListAction: void <init>(java.lang.String,java.lang.String,java.lang.String,at.bestsolution.drawswf.DrawingPanel,int,at.bestsolution.drawswf.DrawObjectList)>/java.lang.StringBuffer.<init>/0	<java.lang.StringBuffer: void <init>()>
<at.bestsolution.drawswf.actions.ObjectListAction: void <init>(java.lang.String,java.lang.String,java.lang.String,at.bestsolution.drawswf.DrawingPanel,int,at.bestsolution.drawswf.DrawObjectList)>/java.lang.StringBuffer.append/0	<java.lang.StringBuffer: java.lang.StringBuffer append(java.lang.String)>
<at.bestsolution.drawswf.actions.ObjectListAction: void <init>(java.lang.String,java.lang.String,java.lang.String,at.bestsolution.drawswf.DrawingPanel,int,at.bestsolution.drawswf.DrawObjectList)>/at.bestsolution.drawswf.actions.AbstractDrawAction.<init>/0	<at.bestsolution.drawswf.actions.AbstractDrawAction: void <init>(java.lang.String,java.lang.String,java.lang.String,at.bestsolution.drawswf.DrawingPanel,int,javax.swing.KeyStroke)>
<at.bestsolution.drawswf.actions.OpenOptionsDialogAction: void <init>(java.lang.String,java.lang.String,java.lang.String,at.bestsolution.drawswf.DrawingPanel,int,javax.swing.KeyStroke)>/java.lang.StringBuffer.<init>/0	<java.lang.StringBuffer: void <init>()>
<at.bestsolution.drawswf.actions.OpenOptionsDialogAction: void <init>(java.lang.String,java.lang.String,java.lang.String,at.bestsolution.drawswf.DrawingPanel,int,javax.swing.KeyStroke)>/java.lang.StringBuffer.append/0	<java.lang.StringBuffer: java.lang.StringBuffer append(java.lang.String)>
<at.bestsolution.drawswf.actions.OpenOptionsDialogAction: void <init>(java.lang.String,java.lang.String,java.lang.String,at.bestsolution.drawswf.DrawingPanel,int,javax.swing.KeyStroke)>/at.bestsolution.drawswf.actions.AbstractDrawAction.<init>/0	<at.bestsolution.drawswf.actions.AbstractDrawAction: void <init>(java.lang.String,java.lang.String,java.lang.String,at.bestsolution.drawswf.DrawingPanel,int,javax.swing.KeyStroke)>
<at.bestsolution.drawswf.actions.PlayAction: void <init>(java.lang.String,java.lang.String,at.bestsolution.drawswf.DrawingPanel,boolean)>/java.lang.StringBuffer.<init>/0	<java.lang.StringBuffer: void <init>()>
<at.bestsolution.drawswf.actions.PlayAction: void <init>(java.lang.String,java.lang.String,at.bestsolution.drawswf.DrawingPanel,boolean)>/java.lang.StringBuffer.append/0	<java.lang.StringBuffer: java.lang.StringBuffer append(java.lang.String)>
<at.bestsolution.drawswf.actions.PlayAction: void <init>(java.lang.String,java.lang.String,at.bestsolution.drawswf.DrawingPanel,boolean)>/at.bestsolution.drawswf.actions.AbstractDrawAction.<init>/0	<at.bestsolution.drawswf.actions.AbstractDrawAction: void <init>(java.lang.String,java.lang.String,at.bestsolution.drawswf.DrawingPanel)>
<at.bestsolution.drawswf.actions.PlayAction: void <init>(java.lang.String,java.lang.String,java.lang.String,at.bestsolution.drawswf.DrawingPanel,int,javax.swing.KeyStroke,boolean)>/java.lang.StringBuffer.<init>/0	<java.lang.StringBuffer: void <init>()>
<at.bestsolution.drawswf.actions.PlayAction: void <init>(java.lang.String,java.lang.String,java.lang.String,at.bestsolution.drawswf.DrawingPanel,int,javax.swing.KeyStroke,boolean)>/java.lang.StringBuffer.append/0	<java.lang.StringBuffer: java.lang.StringBuffer append(java.lang.String)>
<at.bestsolution.drawswf.actions.PlayAction: void <init>(java.lang.String,java.lang.String,java.lang.String,at.bestsolution.drawswf.DrawingPanel,int,javax.swing.KeyStroke,boolean)>/at.bestsolution.drawswf.actions.AbstractDrawAction.<init>/0	<at.bestsolution.drawswf.actions.AbstractDrawAction: void <init>(java.lang.String,java.lang.String,java.lang.String,at.bestsolution.drawswf.DrawingPanel,int,javax.swing.KeyStroke)>
<at.bestsolution.drawswf.actions.RedoAction: void <init>(java.lang.String,java.lang.String,at.bestsolution.drawswf.DrawingPanel)>/java.lang.StringBuffer.<init>/0	<java.lang.StringBuffer: void <init>()>
<at.bestsolution.drawswf.actions.RedoAction: void <init>(java.lang.String,java.lang.String,at.bestsolution.drawswf.DrawingPanel)>/java.lang.StringBuffer.append/0	<java.lang.StringBuffer: java.lang.StringBuffer append(java.lang.String)>
<at.bestsolution.drawswf.actions.RedoAction: void <init>(java.lang.String,java.lang.String,at.bestsolution.drawswf.DrawingPanel)>/at.bestsolution.drawswf.actions.AbstractDrawAction.<init>/0	<at.bestsolution.drawswf.actions.AbstractDrawAction: void <init>(java.lang.String,java.lang.String,at.bestsolution.drawswf.DrawingPanel)>
<at.bestsolution.drawswf.actions.RedoAction: void <init>(java.lang.String,java.lang.String,java.lang.String,at.bestsolution.drawswf.DrawingPanel,int,javax.swing.KeyStroke)>/java.lang.StringBuffer.<init>/0	<java.lang.StringBuffer: void <init>()>
<at.bestsolution.drawswf.actions.RedoAction: void <init>(java.lang.String,java.lang.String,java.lang.String,at.bestsolution.drawswf.DrawingPanel,int,javax.swing.KeyStroke)>/java.lang.StringBuffer.append/0	<java.lang.StringBuffer: java.lang.StringBuffer append(java.lang.String)>
<at.bestsolution.drawswf.actions.RedoAction: void <init>(java.lang.String,java.lang.String,java.lang.String,at.bestsolution.drawswf.DrawingPanel,int,javax.swing.KeyStroke)>/at.bestsolution.drawswf.actions.AbstractDrawAction.<init>/0	<at.bestsolution.drawswf.actions.AbstractDrawAction: void <init>(java.lang.String,java.lang.String,java.lang.String,at.bestsolution.drawswf.DrawingPanel,int,javax.swing.KeyStroke)>
<at.bestsolution.drawswf.actions.SaveAction: void <init>(java.lang.String,java.lang.String,at.bestsolution.drawswf.DrawingPanel)>/java.lang.StringBuffer.<init>/0	<java.lang.StringBuffer: void <init>()>
<at.bestsolution.drawswf.actions.SaveAction: void <init>(java.lang.String,java.lang.String,at.bestsolution.drawswf.DrawingPanel)>/java.lang.StringBuffer.append/0	<java.lang.StringBuffer: java.lang.StringBuffer append(java.lang.String)>
<at.bestsolution.drawswf.actions.SaveAction: void <init>(java.lang.String,java.lang.String,at.bestsolution.drawswf.DrawingPanel)>/at.bestsolution.drawswf.actions.AbstractDrawAction.<init>/0	<at.bestsolution.drawswf.actions.AbstractDrawAction: void <init>(java.lang.String,java.lang.String,at.bestsolution.drawswf.DrawingPanel)>
<at.bestsolution.drawswf.actions.SaveAction: void <init>(java.lang.String,java.lang.String,java.lang.String,at.bestsolution.drawswf.DrawingPanel,int,javax.swing.KeyStroke)>/java.lang.StringBuffer.<init>/0	<java.lang.StringBuffer: void <init>()>
<at.bestsolution.drawswf.actions.SaveAction: void <init>(java.lang.String,java.lang.String,java.lang.String,at.bestsolution.drawswf.DrawingPanel,int,javax.swing.KeyStroke)>/java.lang.StringBuffer.append/0	<java.lang.StringBuffer: java.lang.StringBuffer append(java.lang.String)>
<at.bestsolution.drawswf.actions.SaveAction: void <init>(java.lang.String,java.lang.String,java.lang.String,at.bestsolution.drawswf.DrawingPanel,int,javax.swing.KeyStroke)>/at.bestsolution.drawswf.actions.AbstractDrawAction.<init>/0	<at.bestsolution.drawswf.actions.AbstractDrawAction: void <init>(java.lang.String,java.lang.String,java.lang.String,at.bestsolution.drawswf.DrawingPanel,int,javax.swing.KeyStroke)>
<at.bestsolution.drawswf.actions.SaveSWFAction: void <init>(java.lang.String,java.lang.String,at.bestsolution.drawswf.DrawingPanel)>/java.lang.StringBuffer.<init>/0	<java.lang.StringBuffer: void <init>()>
<at.bestsolution.drawswf.actions.SaveSWFAction: void <init>(java.lang.String,java.lang.String,at.bestsolution.drawswf.DrawingPanel)>/java.lang.StringBuffer.append/0	<java.lang.StringBuffer: java.lang.StringBuffer append(java.lang.String)>
<at.bestsolution.drawswf.actions.SaveSWFAction: void <init>(java.lang.String,java.lang.String,at.bestsolution.drawswf.DrawingPanel)>/at.bestsolution.drawswf.actions.AbstractDrawAction.<init>/0	<at.bestsolution.drawswf.actions.AbstractDrawAction: void <init>(java.lang.String,java.lang.String,at.bestsolution.drawswf.DrawingPanel)>
<at.bestsolution.drawswf.actions.SaveSWFAction: void <init>(java.lang.String,java.lang.String,java.lang.String,at.bestsolution.drawswf.DrawingPanel,int,javax.swing.KeyStroke)>/java.lang.StringBuffer.<init>/0	<java.lang.StringBuffer: void <init>()>
<at.bestsolution.drawswf.actions.SaveSWFAction: void <init>(java.lang.String,java.lang.String,java.lang.String,at.bestsolution.drawswf.DrawingPanel,int,javax.swing.KeyStroke)>/java.lang.StringBuffer.append/0	<java.lang.StringBuffer: java.lang.StringBuffer append(java.lang.String)>
<at.bestsolution.drawswf.actions.SaveSWFAction: void <init>(java.lang.String,java.lang.String,java.lang.String,at.bestsolution.drawswf.DrawingPanel,int,javax.swing.KeyStroke)>/at.bestsolution.drawswf.actions.AbstractDrawAction.<init>/0	<at.bestsolution.drawswf.actions.AbstractDrawAction: void <init>(java.lang.String,java.lang.String,java.lang.String,at.bestsolution.drawswf.DrawingPanel,int,javax.swing.KeyStroke)>
<at.bestsolution.drawswf.actions.SetCanvasSizeAction: void <init>(java.lang.String,java.lang.String,at.bestsolution.drawswf.DrawingPanel,javax.swing.JFrame)>/java.lang.StringBuffer.<init>/0	<java.lang.StringBuffer: void <init>()>
<at.bestsolution.drawswf.actions.SetCanvasSizeAction: void <init>(java.lang.String,java.lang.String,at.bestsolution.drawswf.DrawingPanel,javax.swing.JFrame)>/java.lang.StringBuffer.append/0	<java.lang.StringBuffer: java.lang.StringBuffer append(java.lang.String)>
<at.bestsolution.drawswf.actions.SetCanvasSizeAction: void <init>(java.lang.String,java.lang.String,at.bestsolution.drawswf.DrawingPanel,javax.swing.JFrame)>/at.bestsolution.drawswf.actions.AbstractDrawAction.<init>/0	<at.bestsolution.drawswf.actions.AbstractDrawAction: void <init>(java.lang.String,java.lang.String,at.bestsolution.drawswf.DrawingPanel)>
<at.bestsolution.drawswf.actions.SetCanvasSizeAction: void <init>(java.lang.String,java.lang.String,java.lang.String,at.bestsolution.drawswf.DrawingPanel,javax.swing.JFrame,int,javax.swing.KeyStroke)>/java.lang.StringBuffer.<init>/0	<java.lang.StringBuffer: void <init>()>
<at.bestsolution.drawswf.actions.SetCanvasSizeAction: void <init>(java.lang.String,java.lang.String,java.lang.String,at.bestsolution.drawswf.DrawingPanel,javax.swing.JFrame,int,javax.swing.KeyStroke)>/java.lang.StringBuffer.append/0	<java.lang.StringBuffer: java.lang.StringBuffer append(java.lang.String)>
<at.bestsolution.drawswf.actions.SetCanvasSizeAction: void <init>(java.lang.String,java.lang.String,java.lang.String,at.bestsolution.drawswf.DrawingPanel,javax.swing.JFrame,int,javax.swing.KeyStroke)>/at.bestsolution.drawswf.actions.AbstractDrawAction.<init>/0	<at.bestsolution.drawswf.actions.AbstractDrawAction: void <init>(java.lang.String,java.lang.String,java.lang.String,at.bestsolution.drawswf.DrawingPanel,int,javax.swing.KeyStroke)>
<at.bestsolution.drawswf.actions.SetDrawingModeAction: void <init>(java.lang.String,at.bestsolution.drawswf.DrawingPanel,int,at.bestsolution.drawswf.MainWindow,int)>/javax.swing.AbstractAction.<init>/0	<javax.swing.AbstractAction: void <init>()>
<at.bestsolution.drawswf.actions.SetDrawingModeAction: void <init>(java.lang.String,at.bestsolution.drawswf.DrawingPanel,int,at.bestsolution.drawswf.MainWindow,int)>/at.bestsolution.drawswf.actions.SetDrawingModeAction.putValue/0	<javax.swing.AbstractAction: void putValue(java.lang.String,java.lang.Object)>
<at.bestsolution.drawswf.actions.SetDrawingModeAction: void <init>(java.lang.String,java.lang.String,at.bestsolution.drawswf.DrawingPanel,int,int,javax.swing.KeyStroke,at.bestsolution.drawswf.MainWindow,int)>/javax.swing.AbstractAction.<init>/0	<javax.swing.AbstractAction: void <init>()>
<at.bestsolution.drawswf.actions.SetDrawingModeAction: void <init>(java.lang.String,java.lang.String,at.bestsolution.drawswf.DrawingPanel,int,int,javax.swing.KeyStroke,at.bestsolution.drawswf.MainWindow,int)>/at.bestsolution.drawswf.actions.SetDrawingModeAction.putValue/0	<javax.swing.AbstractAction: void putValue(java.lang.String,java.lang.Object)>
<at.bestsolution.drawswf.actions.SetDrawingModeAction: void <init>(java.lang.String,java.lang.String,at.bestsolution.drawswf.DrawingPanel,int,int,javax.swing.KeyStroke,at.bestsolution.drawswf.MainWindow,int)>/at.bestsolution.drawswf.actions.SetDrawingModeAction.putValue/1	<javax.swing.AbstractAction: void putValue(java.lang.String,java.lang.Object)>
<at.bestsolution.drawswf.actions.SetDrawingModeAction: void <init>(java.lang.String,java.lang.String,at.bestsolution.drawswf.DrawingPanel,int,int,javax.swing.KeyStroke,at.bestsolution.drawswf.MainWindow,int)>/java.lang.Integer.<init>/0	<java.lang.Integer: void <init>(int)>
<at.bestsolution.drawswf.actions.SetDrawingModeAction: void <init>(java.lang.String,java.lang.String,at.bestsolution.drawswf.DrawingPanel,int,int,javax.swing.KeyStroke,at.bestsolution.drawswf.MainWindow,int)>/at.bestsolution.drawswf.actions.SetDrawingModeAction.putValue/2	<javax.swing.AbstractAction: void putValue(java.lang.String,java.lang.Object)>
<at.bestsolution.drawswf.actions.SetLineWidthAction: void <init>(java.lang.String,java.lang.String,at.bestsolution.drawswf.DrawingPanel)>/java.lang.StringBuffer.<init>/0	<java.lang.StringBuffer: void <init>()>
<at.bestsolution.drawswf.actions.SetLineWidthAction: void <init>(java.lang.String,java.lang.String,at.bestsolution.drawswf.DrawingPanel)>/java.lang.StringBuffer.append/0	<java.lang.StringBuffer: java.lang.StringBuffer append(java.lang.String)>
<at.bestsolution.drawswf.actions.SetLineWidthAction: void <init>(java.lang.String,java.lang.String,at.bestsolution.drawswf.DrawingPanel)>/at.bestsolution.drawswf.actions.AbstractDrawAction.<init>/0	<at.bestsolution.drawswf.actions.AbstractDrawAction: void <init>(java.lang.String,java.lang.String,at.bestsolution.drawswf.DrawingPanel)>
<at.bestsolution.drawswf.actions.SetLineWidthAction: void <init>(java.lang.String,java.lang.String,java.lang.String,at.bestsolution.drawswf.DrawingPanel,int,javax.swing.KeyStroke)>/java.lang.StringBuffer.<init>/0	<java.lang.StringBuffer: void <init>()>
<at.bestsolution.drawswf.actions.SetLineWidthAction: void <init>(java.lang.String,java.lang.String,java.lang.String,at.bestsolution.drawswf.DrawingPanel,int,javax.swing.KeyStroke)>/java.lang.StringBuffer.append/0	<java.lang.StringBuffer: java.lang.StringBuffer append(java.lang.String)>
<at.bestsolution.drawswf.actions.SetLineWidthAction: void <init>(java.lang.String,java.lang.String,java.lang.String,at.bestsolution.drawswf.DrawingPanel,int,javax.swing.KeyStroke)>/at.bestsolution.drawswf.actions.AbstractDrawAction.<init>/0	<at.bestsolution.drawswf.actions.AbstractDrawAction: void <init>(java.lang.String,java.lang.String,java.lang.String,at.bestsolution.drawswf.DrawingPanel,int,javax.swing.KeyStroke)>
<at.bestsolution.drawswf.actions.UndoAction: void <init>(java.lang.String,java.lang.String,at.bestsolution.drawswf.DrawingPanel)>/java.lang.StringBuffer.<init>/0	<java.lang.StringBuffer: void <init>()>
<at.bestsolution.drawswf.actions.UndoAction: void <init>(java.lang.String,java.lang.String,at.bestsolution.drawswf.DrawingPanel)>/java.lang.StringBuffer.append/0	<java.lang.StringBuffer: java.lang.StringBuffer append(java.lang.String)>
<at.bestsolution.drawswf.actions.UndoAction: void <init>(java.lang.String,java.lang.String,at.bestsolution.drawswf.DrawingPanel)>/at.bestsolution.drawswf.actions.AbstractDrawAction.<init>/0	<at.bestsolution.drawswf.actions.AbstractDrawAction: void <init>(java.lang.String,java.lang.String,at.bestsolution.drawswf.DrawingPanel)>
<at.bestsolution.drawswf.actions.UndoAction: void <init>(java.lang.String,java.lang.String,java.lang.String,at.bestsolution.drawswf.DrawingPanel,int,javax.swing.KeyStroke)>/java.lang.StringBuffer.<init>/0	<java.lang.StringBuffer: void <init>()>
<at.bestsolution.drawswf.actions.UndoAction: void <init>(java.lang.String,java.lang.String,java.lang.String,at.bestsolution.drawswf.DrawingPanel,int,javax.swing.KeyStroke)>/java.lang.StringBuffer.append/0	<java.lang.StringBuffer: java.lang.StringBuffer append(java.lang.String)>
<at.bestsolution.drawswf.actions.UndoAction: void <init>(java.lang.String,java.lang.String,java.lang.String,at.bestsolution.drawswf.DrawingPanel,int,javax.swing.KeyStroke)>/at.bestsolution.drawswf.actions.AbstractDrawAction.<init>/0	<at.bestsolution.drawswf.actions.AbstractDrawAction: void <init>(java.lang.String,java.lang.String,java.lang.String,at.bestsolution.drawswf.DrawingPanel,int,javax.swing.KeyStroke)>
<at.bestsolution.drawswf.menu.DrawEditMenu: void <init>(java.lang.String,char)>/javax.swing.JMenu.<init>/0	<javax.swing.JMenu: void <init>(java.lang.String)>
<at.bestsolution.drawswf.menu.DrawEditMenu: void <init>(java.lang.String,char)>/at.bestsolution.drawswf.menu.DrawEditMenu.setMnemonic/0	<javax.swing.AbstractButton: void setMnemonic(char)>
<at.bestsolution.drawswf.menu.DrawEditMenu: void <init>(java.lang.String,char)>/at.bestsolution.drawswf.menu.DrawEditMenu.initMenu/0	<at.bestsolution.drawswf.menu.DrawEditMenu: void initMenu()>
<at.bestsolution.drawswf.menu.DrawEditMenu: void addClearAction(java.lang.String,java.lang.String,java.lang.String,int,javax.swing.KeyStroke)>/at.bestsolution.drawswf.MainWindow.getDrawingPanel/0	<at.bestsolution.drawswf.MainWindow: at.bestsolution.drawswf.DrawingPanel getDrawingPanel()>
<at.bestsolution.drawswf.menu.DrawEditMenu: void addClearAction(java.lang.String,java.lang.String,java.lang.String,int,javax.swing.KeyStroke)>/at.bestsolution.drawswf.actions.ClearAction.<init>/0	<at.bestsolution.drawswf.actions.ClearAction: void <init>(java.lang.String,java.lang.String,java.lang.String,at.bestsolution.drawswf.DrawingPanel,int,javax.swing.KeyStroke)>
<at.bestsolution.drawswf.menu.DrawEditMenu: void addClearAction(java.lang.String,java.lang.String,java.lang.String,int,javax.swing.KeyStroke)>/at.bestsolution.drawswf.menu.DrawEditMenu.add/0	<javax.swing.JMenu: javax.swing.JMenuItem add(javax.swing.Action)>
<at.bestsolution.drawswf.menu.DrawEditMenu: void addRedoAction(java.lang.String,java.lang.String,java.lang.String,int,javax.swing.KeyStroke)>/at.bestsolution.drawswf.MainWindow.getDrawingPanel/0	<at.bestsolution.drawswf.MainWindow: at.bestsolution.drawswf.DrawingPanel getDrawingPanel()>
<at.bestsolution.drawswf.menu.DrawEditMenu: void addRedoAction(java.lang.String,java.lang.String,java.lang.String,int,javax.swing.KeyStroke)>/at.bestsolution.drawswf.actions.RedoAction.<init>/0	<at.bestsolution.drawswf.actions.RedoAction: void <init>(java.lang.String,java.lang.String,java.lang.String,at.bestsolution.drawswf.DrawingPanel,int,javax.swing.KeyStroke)>
<at.bestsolution.drawswf.menu.DrawEditMenu: void addRedoAction(java.lang.String,java.lang.String,java.lang.String,int,javax.swing.KeyStroke)>/at.bestsolution.drawswf.menu.DrawEditMenu.add/0	<javax.swing.JMenu: javax.swing.JMenuItem add(javax.swing.Action)>
<at.bestsolution.drawswf.menu.DrawEditMenu: void addUndoAction(java.lang.String,java.lang.String,java.lang.String,int,javax.swing.KeyStroke)>/at.bestsolution.drawswf.MainWindow.getDrawingPanel/0	<at.bestsolution.drawswf.MainWindow: at.bestsolution.drawswf.DrawingPanel getDrawingPanel()>
<at.bestsolution.drawswf.menu.DrawEditMenu: void addUndoAction(java.lang.String,java.lang.String,java.lang.String,int,javax.swing.KeyStroke)>/at.bestsolution.drawswf.actions.UndoAction.<init>/0	<at.bestsolution.drawswf.actions.UndoAction: void <init>(java.lang.String,java.lang.String,java.lang.String,at.bestsolution.drawswf.DrawingPanel,int,javax.swing.KeyStroke)>
<at.bestsolution.drawswf.menu.DrawEditMenu: void addUndoAction(java.lang.String,java.lang.String,java.lang.String,int,javax.swing.KeyStroke)>/at.bestsolution.drawswf.menu.DrawEditMenu.add/0	<javax.swing.JMenu: javax.swing.JMenuItem add(javax.swing.Action)>
<at.bestsolution.drawswf.menu.DrawEditMenu: void initMenu()>/at.bestsolution.drawswf.MainWindow.getI18n/0	<at.bestsolution.drawswf.MainWindow: java.util.ResourceBundle getI18n()>
<at.bestsolution.drawswf.menu.DrawEditMenu: void initMenu()>/at.bestsolution.drawswf.MainWindow.getI18n/1	<at.bestsolution.drawswf.MainWindow: java.util.ResourceBundle getI18n()>
<at.bestsolution.drawswf.menu.DrawEditMenu: void initMenu()>/at.bestsolution.drawswf.MainWindow.getI18n/2	<at.bestsolution.drawswf.MainWindow: java.util.ResourceBundle getI18n()>
<at.bestsolution.drawswf.menu.DrawEditMenu: void initMenu()>/javax.swing.KeyStroke.getKeyStroke/0	<javax.swing.KeyStroke: javax.swing.KeyStroke getKeyStroke(int,int)>
<at.bestsolution.drawswf.menu.DrawEditMenu: void initMenu()>/at.bestsolution.drawswf.menu.DrawEditMenu.addUndoAction/0	<at.bestsolution.drawswf.menu.DrawEditMenu: void addUndoAction(java.lang.String,java.lang.String,java.lang.String,int,javax.swing.KeyStroke)>
<at.bestsolution.drawswf.menu.DrawEditMenu: void initMenu()>/at.bestsolution.drawswf.MainWindow.getI18n/3	<at.bestsolution.drawswf.MainWindow: java.util.ResourceBundle getI18n()>
<at.bestsolution.drawswf.menu.DrawEditMenu: void initMenu()>/at.bestsolution.drawswf.MainWindow.getI18n/4	<at.bestsolution.drawswf.MainWindow: java.util.ResourceBundle getI18n()>
<at.bestsolution.drawswf.menu.DrawEditMenu: void initMenu()>/at.bestsolution.drawswf.MainWindow.getI18n/5	<at.bestsolution.drawswf.MainWindow: java.util.ResourceBundle getI18n()>
<at.bestsolution.drawswf.menu.DrawEditMenu: void initMenu()>/javax.swing.KeyStroke.getKeyStroke/1	<javax.swing.KeyStroke: javax.swing.KeyStroke getKeyStroke(int,int)>
<at.bestsolution.drawswf.menu.DrawEditMenu: void initMenu()>/at.bestsolution.drawswf.menu.DrawEditMenu.addRedoAction/0	<at.bestsolution.drawswf.menu.DrawEditMenu: void addRedoAction(java.lang.String,java.lang.String,java.lang.String,int,javax.swing.KeyStroke)>
<at.bestsolution.drawswf.menu.DrawEditMenu: void initMenu()>/at.bestsolution.drawswf.MainWindow.getI18n/6	<at.bestsolution.drawswf.MainWindow: java.util.ResourceBundle getI18n()>
<at.bestsolution.drawswf.menu.DrawEditMenu: void initMenu()>/at.bestsolution.drawswf.MainWindow.getI18n/7	<at.bestsolution.drawswf.MainWindow: java.util.ResourceBundle getI18n()>
<at.bestsolution.drawswf.menu.DrawEditMenu: void initMenu()>/at.bestsolution.drawswf.MainWindow.getI18n/8	<at.bestsolution.drawswf.MainWindow: java.util.ResourceBundle getI18n()>
<at.bestsolution.drawswf.menu.DrawEditMenu: void initMenu()>/javax.swing.KeyStroke.getKeyStroke/2	<javax.swing.KeyStroke: javax.swing.KeyStroke getKeyStroke(int,int)>
<at.bestsolution.drawswf.menu.DrawEditMenu: void initMenu()>/at.bestsolution.drawswf.menu.DrawEditMenu.addClearAction/0	<at.bestsolution.drawswf.menu.DrawEditMenu: void addClearAction(java.lang.String,java.lang.String,java.lang.String,int,javax.swing.KeyStroke)>
<at.bestsolution.drawswf.menu.DrawFileMenu: void <init>(java.lang.String,char)>/javax.swing.JMenu.<init>/0	<javax.swing.JMenu: void <init>(java.lang.String)>
<at.bestsolution.drawswf.menu.DrawFileMenu: void <init>(java.lang.String,char)>/at.bestsolution.drawswf.menu.DrawFileMenu.setMnemonic/0	<javax.swing.AbstractButton: void setMnemonic(char)>
<at.bestsolution.drawswf.menu.DrawFileMenu: void <init>(java.lang.String,char)>/at.bestsolution.drawswf.menu.DrawFileMenu.initMenu/0	<at.bestsolution.drawswf.menu.DrawFileMenu: void initMenu()>
<at.bestsolution.drawswf.menu.DrawFileMenu: void addFileAction(java.lang.String,java.lang.String,java.lang.String,boolean,int,javax.swing.KeyStroke,boolean)>/at.bestsolution.drawswf.MainWindow.getDrawingPanel/0	<at.bestsolution.drawswf.MainWindow: at.bestsolution.drawswf.DrawingPanel getDrawingPanel()>
<at.bestsolution.drawswf.menu.DrawFileMenu: void addFileAction(java.lang.String,java.lang.String,java.lang.String,boolean,int,javax.swing.KeyStroke,boolean)>/at.bestsolution.drawswf.actions.FileAction.<init>/0	<at.bestsolution.drawswf.actions.FileAction: void <init>(java.lang.String,java.lang.String,java.lang.String,at.bestsolution.drawswf.DrawingPanel,boolean,int,javax.swing.KeyStroke,boolean)>
<at.bestsolution.drawswf.menu.DrawFileMenu: void addFileAction(java.lang.String,java.lang.String,java.lang.String,boolean,int,javax.swing.KeyStroke,boolean)>/at.bestsolution.drawswf.menu.DrawFileMenu.add/0	<javax.swing.JMenu: javax.swing.JMenuItem add(javax.swing.Action)>
<at.bestsolution.drawswf.menu.DrawFileMenu: void addGraphicTemplateAction(java.lang.String,java.lang.String,java.lang.String,int,javax.swing.KeyStroke)>/at.bestsolution.drawswf.MainWindow.getDrawingPanel/0	<at.bestsolution.drawswf.MainWindow: at.bestsolution.drawswf.DrawingPanel getDrawingPanel()>
<at.bestsolution.drawswf.menu.DrawFileMenu: void addGraphicTemplateAction(java.lang.String,java.lang.String,java.lang.String,int,javax.swing.KeyStroke)>/at.bestsolution.drawswf.actions.GraphicTemplateAction.<init>/0	<at.bestsolution.drawswf.actions.GraphicTemplateAction: void <init>(java.lang.String,java.lang.String,java.lang.String,at.bestsolution.drawswf.DrawingPanel,int,javax.swing.KeyStroke)>
<at.bestsolution.drawswf.menu.DrawFileMenu: void addGraphicTemplateAction(java.lang.String,java.lang.String,java.lang.String,int,javax.swing.KeyStroke)>/at.bestsolution.drawswf.menu.DrawFileMenu.add/0	<javax.swing.JMenu: javax.swing.JMenuItem add(javax.swing.Action)>
<at.bestsolution.drawswf.menu.DrawFileMenu: void addNewFileAction(java.lang.String,java.lang.String,java.lang.String,int,javax.swing.KeyStroke)>/at.bestsolution.drawswf.MainWindow.getDrawingPanel/0	<at.bestsolution.drawswf.MainWindow: at.bestsolution.drawswf.DrawingPanel getDrawingPanel()>
<at.bestsolution.drawswf.menu.DrawFileMenu: void addNewFileAction(java.lang.String,java.lang.String,java.lang.String,int,javax.swing.KeyStroke)>/at.bestsolution.drawswf.actions.NewFileAction.<init>/0	<at.bestsolution.drawswf.actions.NewFileAction: void <init>(java.lang.String,java.lang.String,java.lang.String,at.bestsolution.drawswf.DrawingPanel,int,javax.swing.KeyStroke)>
<at.bestsolution.drawswf.menu.DrawFileMenu: void addNewFileAction(java.lang.String,java.lang.String,java.lang.String,int,javax.swing.KeyStroke)>/at.bestsolution.drawswf.menu.DrawFileMenu.add/0	<javax.swing.JMenu: javax.swing.JMenuItem add(javax.swing.Action)>
<at.bestsolution.drawswf.menu.DrawFileMenu: void addSaveAction(java.lang.String,java.lang.String,java.lang.String,int,javax.swing.KeyStroke)>/at.bestsolution.drawswf.MainWindow.getDrawingPanel/0	<at.bestsolution.drawswf.MainWindow: at.bestsolution.drawswf.DrawingPanel getDrawingPanel()>
<at.bestsolution.drawswf.menu.DrawFileMenu: void addSaveAction(java.lang.String,java.lang.String,java.lang.String,int,javax.swing.KeyStroke)>/at.bestsolution.drawswf.actions.SaveAction.<init>/0	<at.bestsolution.drawswf.actions.SaveAction: void <init>(java.lang.String,java.lang.String,java.lang.String,at.bestsolution.drawswf.DrawingPanel,int,javax.swing.KeyStroke)>
<at.bestsolution.drawswf.menu.DrawFileMenu: void addSaveAction(java.lang.String,java.lang.String,java.lang.String,int,javax.swing.KeyStroke)>/at.bestsolution.drawswf.menu.DrawFileMenu.add/0	<javax.swing.JMenu: javax.swing.JMenuItem add(javax.swing.Action)>
<at.bestsolution.drawswf.menu.DrawFileMenu: void addSaveSWFAction(java.lang.String,java.lang.String,java.lang.String,int,javax.swing.KeyStroke)>/at.bestsolution.drawswf.MainWindow.getDrawingPanel/0	<at.bestsolution.drawswf.MainWindow: at.bestsolution.drawswf.DrawingPanel getDrawingPanel()>
<at.bestsolution.drawswf.menu.DrawFileMenu: void addSaveSWFAction(java.lang.String,java.lang.String,java.lang.String,int,javax.swing.KeyStroke)>/at.bestsolution.drawswf.actions.SaveSWFAction.<init>/0	<at.bestsolution.drawswf.actions.SaveSWFAction: void <init>(java.lang.String,java.lang.String,java.lang.String,at.bestsolution.drawswf.DrawingPanel,int,javax.swing.KeyStroke)>
<at.bestsolution.drawswf.menu.DrawFileMenu: void addSaveSWFAction(java.lang.String,java.lang.String,java.lang.String,int,javax.swing.KeyStroke)>/at.bestsolution.drawswf.menu.DrawFileMenu.add/0	<javax.swing.JMenu: javax.swing.JMenuItem add(javax.swing.Action)>
<at.bestsolution.drawswf.menu.DrawFileMenu: void initMenu()>/at.bestsolution.drawswf.MainWindow.getI18n/0	<at.bestsolution.drawswf.MainWindow: java.util.ResourceBundle getI18n()>
<at.bestsolution.drawswf.menu.DrawFileMenu: void initMenu()>/javax.swing.KeyStroke.getKeyStroke/0	<javax.swing.KeyStroke: javax.swing.KeyStroke getKeyStroke(int,int)>
<at.bestsolution.drawswf.menu.DrawFileMenu: void initMenu()>/at.bestsolution.drawswf.menu.DrawFileMenu.addNewFileAction/0	<at.bestsolution.drawswf.menu.DrawFileMenu: void addNewFileAction(java.lang.String,java.lang.String,java.lang.String,int,javax.swing.KeyStroke)>
<at.bestsolution.drawswf.menu.DrawFileMenu: void initMenu()>/javax.swing.KeyStroke.getKeyStroke/1	<javax.swing.KeyStroke: javax.swing.KeyStroke getKeyStroke(int,int)>
<at.bestsolution.drawswf.menu.DrawFileMenu: void initMenu()>/at.bestsolution.drawswf.menu.DrawFileMenu.addFileAction/0	<at.bestsolution.drawswf.menu.DrawFileMenu: void addFileAction(java.lang.String,java.lang.String,java.lang.String,boolean,int,javax.swing.KeyStroke,boolean)>
<at.bestsolution.drawswf.menu.DrawFileMenu: void initMenu()>/at.bestsolution.drawswf.menu.DrawFileMenu.addFileAction/1	<at.bestsolution.drawswf.menu.DrawFileMenu: void addFileAction(java.lang.String,java.lang.String,java.lang.String,boolean,int,javax.swing.KeyStroke,boolean)>
<at.bestsolution.drawswf.menu.DrawFileMenu: void initMenu()>/at.bestsolution.drawswf.menu.DrawFileMenu.addFileAction/2	<at.bestsolution.drawswf.menu.DrawFileMenu: void addFileAction(java.lang.String,java.lang.String,java.lang.String,boolean,int,javax.swing.KeyStroke,boolean)>
<at.bestsolution.drawswf.menu.DrawFileMenu: void initMenu()>/javax.swing.KeyStroke.getKeyStroke/2	<javax.swing.KeyStroke: javax.swing.KeyStroke getKeyStroke(int,int)>
<at.bestsolution.drawswf.menu.DrawFileMenu: void initMenu()>/at.bestsolution.drawswf.menu.DrawFileMenu.addSaveAction/0	<at.bestsolution.drawswf.menu.DrawFileMenu: void addSaveAction(java.lang.String,java.lang.String,java.lang.String,int,javax.swing.KeyStroke)>
<at.bestsolution.drawswf.menu.DrawFileMenu: void initMenu()>/at.bestsolution.drawswf.menu.DrawFileMenu.addGraphicTemplateAction/0	<at.bestsolution.drawswf.menu.DrawFileMenu: void addGraphicTemplateAction(java.lang.String,java.lang.String,java.lang.String,int,javax.swing.KeyStroke)>
<at.bestsolution.drawswf.menu.DrawFileMenu: void initMenu()>/javax.swing.KeyStroke.getKeyStroke/3	<javax.swing.KeyStroke: javax.swing.KeyStroke getKeyStroke(int,int)>
<at.bestsolution.drawswf.menu.DrawFileMenu: void initMenu()>/at.bestsolution.drawswf.menu.DrawFileMenu.addSaveSWFAction/0	<at.bestsolution.drawswf.menu.DrawFileMenu: void addSaveSWFAction(java.lang.String,java.lang.String,java.lang.String,int,javax.swing.KeyStroke)>
<at.bestsolution.drawswf.menu.DrawFileMenu: void initMenu()>/at.bestsolution.drawswf.menu.DrawFileMenu.addSeparator/0	<javax.swing.JMenu: void addSeparator()>
<at.bestsolution.drawswf.menu.DrawFileMenu: void initMenu()>/at.bestsolution.drawswf.MainWindow.getDrawingPanel/0	<at.bestsolution.drawswf.MainWindow: at.bestsolution.drawswf.DrawingPanel getDrawingPanel()>
<at.bestsolution.drawswf.menu.DrawFileMenu: void initMenu()>/javax.swing.KeyStroke.getKeyStroke/4	<javax.swing.KeyStroke: javax.swing.KeyStroke getKeyStroke(int,int)>
<at.bestsolution.drawswf.menu.DrawFileMenu: void initMenu()>/at.bestsolution.drawswf.actions.ExitAction.<init>/0	<at.bestsolution.drawswf.actions.ExitAction: void <init>(java.lang.String,java.lang.String,java.lang.String,at.bestsolution.drawswf.DrawingPanel,int,javax.swing.KeyStroke)>
<at.bestsolution.drawswf.menu.DrawFileMenu: void initMenu()>/at.bestsolution.drawswf.menu.DrawFileMenu.add/0	<javax.swing.JMenu: javax.swing.JMenuItem add(javax.swing.Action)>
<at.bestsolution.drawswf.menu.DrawHelpMenu: void <init>(java.lang.String,char)>/javax.swing.JMenu.<init>/0	<javax.swing.JMenu: void <init>(java.lang.String)>
<at.bestsolution.drawswf.menu.DrawHelpMenu: void <init>(java.lang.String,char)>/at.bestsolution.drawswf.menu.DrawHelpMenu.setMnemonic/0	<javax.swing.AbstractButton: void setMnemonic(char)>
<at.bestsolution.drawswf.menu.DrawHelpMenu: void <init>(java.lang.String,char)>/at.bestsolution.drawswf.menu.DrawHelpMenu.initMenu/0	<at.bestsolution.drawswf.menu.DrawHelpMenu: void initMenu()>
<at.bestsolution.drawswf.menu.DrawHelpMenu: void initMenu()>/at.bestsolution.drawswf.MainWindow.getI18n/0	<at.bestsolution.drawswf.MainWindow: java.util.ResourceBundle getI18n()>
<at.bestsolution.drawswf.menu.DrawHelpMenu: void initMenu()>/at.bestsolution.drawswf.menu.DrawHelpMenu.setMnemonic/0	<javax.swing.AbstractButton: void setMnemonic(char)>
<at.bestsolution.drawswf.menu.DrawHelpMenu: void initMenu()>/at.bestsolution.drawswf.MainWindow.getI18n/1	<at.bestsolution.drawswf.MainWindow: java.util.ResourceBundle getI18n()>
<at.bestsolution.drawswf.menu.DrawHelpMenu: void initMenu()>/at.bestsolution.drawswf.MainWindow.getI18n/2	<at.bestsolution.drawswf.MainWindow: java.util.ResourceBundle getI18n()>
<at.bestsolution.drawswf.menu.DrawHelpMenu: void initMenu()>/at.bestsolution.drawswf.MainWindow.getDrawingPanel/0	<at.bestsolution.drawswf.MainWindow: at.bestsolution.drawswf.DrawingPanel getDrawingPanel()>
<at.bestsolution.drawswf.menu.DrawHelpMenu: void initMenu()>/at.bestsolution.drawswf.MainWindow.getI18n/3	<at.bestsolution.drawswf.MainWindow: java.util.ResourceBundle getI18n()>
<at.bestsolution.drawswf.menu.DrawHelpMenu: void initMenu()>/at.bestsolution.drawswf.actions.AboutAction.<init>/0	<at.bestsolution.drawswf.actions.AboutAction: void <init>(java.lang.String,java.lang.String,java.lang.String,at.bestsolution.drawswf.DrawingPanel,int,javax.swing.KeyStroke)>
<at.bestsolution.drawswf.menu.DrawHelpMenu: void initMenu()>/at.bestsolution.drawswf.menu.DrawHelpMenu.add/0	<javax.swing.JMenu: javax.swing.JMenuItem add(javax.swing.Action)>
<at.bestsolution.drawswf.menu.DrawMovieMenu: void <init>(java.lang.String,char)>/javax.swing.JMenu.<init>/0	<javax.swing.JMenu: void <init>(java.lang.String)>
<at.bestsolution.drawswf.menu.DrawMovieMenu: void <init>(java.lang.String,char)>/at.bestsolution.drawswf.menu.DrawMovieMenu.setMnemonic/0	<javax.swing.AbstractButton: void setMnemonic(char)>
<at.bestsolution.drawswf.menu.DrawMovieMenu: void <init>(java.lang.String,char)>/at.bestsolution.drawswf.menu.DrawMovieMenu.initMenu/0	<at.bestsolution.drawswf.menu.DrawMovieMenu: void initMenu()>
<at.bestsolution.drawswf.menu.DrawMovieMenu: void addPlayAction(java.lang.String,java.lang.String,java.lang.String,int,javax.swing.KeyStroke,boolean)>/at.bestsolution.drawswf.MainWindow.getDrawingPanel/0	<at.bestsolution.drawswf.MainWindow: at.bestsolution.drawswf.DrawingPanel getDrawingPanel()>
<at.bestsolution.drawswf.menu.DrawMovieMenu: void addPlayAction(java.lang.String,java.lang.String,java.lang.String,int,javax.swing.KeyStroke,boolean)>/at.bestsolution.drawswf.actions.PlayAction.<init>/0	<at.bestsolution.drawswf.actions.PlayAction: void <init>(java.lang.String,java.lang.String,java.lang.String,at.bestsolution.drawswf.DrawingPanel,int,javax.swing.KeyStroke,boolean)>
<at.bestsolution.drawswf.menu.DrawMovieMenu: void addPlayAction(java.lang.String,java.lang.String,java.lang.String,int,javax.swing.KeyStroke,boolean)>/at.bestsolution.drawswf.menu.DrawMovieMenu.add/0	<javax.swing.JMenu: javax.swing.JMenuItem add(javax.swing.Action)>
<at.bestsolution.drawswf.menu.DrawMovieMenu: void initMenu()>/at.bestsolution.drawswf.MainWindow.getI18n/0	<at.bestsolution.drawswf.MainWindow: java.util.ResourceBundle getI18n()>
<at.bestsolution.drawswf.menu.DrawMovieMenu: void initMenu()>/at.bestsolution.drawswf.MainWindow.getI18n/1	<at.bestsolution.drawswf.MainWindow: java.util.ResourceBundle getI18n()>
<at.bestsolution.drawswf.menu.DrawMovieMenu: void initMenu()>/at.bestsolution.drawswf.MainWindow.getI18n/2	<at.bestsolution.drawswf.MainWindow: java.util.ResourceBundle getI18n()>
<at.bestsolution.drawswf.menu.DrawMovieMenu: void initMenu()>/at.bestsolution.drawswf.menu.DrawMovieMenu.addPlayAction/0	<at.bestsolution.drawswf.menu.DrawMovieMenu: void addPlayAction(java.lang.String,java.lang.String,java.lang.String,int,javax.swing.KeyStroke,boolean)>
<at.bestsolution.drawswf.menu.DrawMovieMenu: void initMenu()>/at.bestsolution.drawswf.MainWindow.getI18n/3	<at.bestsolution.drawswf.MainWindow: java.util.ResourceBundle getI18n()>
<at.bestsolution.drawswf.menu.DrawMovieMenu: void initMenu()>/at.bestsolution.drawswf.MainWindow.getI18n/4	<at.bestsolution.drawswf.MainWindow: java.util.ResourceBundle getI18n()>
<at.bestsolution.drawswf.menu.DrawMovieMenu: void initMenu()>/at.bestsolution.drawswf.MainWindow.getI18n/5	<at.bestsolution.drawswf.MainWindow: java.util.ResourceBundle getI18n()>
<at.bestsolution.drawswf.menu.DrawMovieMenu: void initMenu()>/at.bestsolution.drawswf.menu.DrawMovieMenu.addPlayAction/1	<at.bestsolution.drawswf.menu.DrawMovieMenu: void addPlayAction(java.lang.String,java.lang.String,java.lang.String,int,javax.swing.KeyStroke,boolean)>
<at.bestsolution.drawswf.menu.DrawToolsMenu: javax.swing.JRadioButtonMenuItem createMenuRadioButton(java.lang.String,java.lang.String,java.lang.String,int,int,javax.swing.KeyStroke,int)>/java.lang.Object.getClass/0	<java.lang.Object: java.lang.Class getClass()>
<at.bestsolution.drawswf.menu.DrawToolsMenu: javax.swing.JRadioButtonMenuItem createMenuRadioButton(java.lang.String,java.lang.String,java.lang.String,int,int,javax.swing.KeyStroke,int)>/java.lang.Class.getClassLoader/0	<java.lang.Class: java.lang.ClassLoader getClassLoader()>
<at.bestsolution.drawswf.menu.DrawToolsMenu: javax.swing.JRadioButtonMenuItem createMenuRadioButton(java.lang.String,java.lang.String,java.lang.String,int,int,javax.swing.KeyStroke,int)>/java.lang.StringBuffer.<init>/0	<java.lang.StringBuffer: void <init>()>
<at.bestsolution.drawswf.menu.DrawToolsMenu: javax.swing.JRadioButtonMenuItem createMenuRadioButton(java.lang.String,java.lang.String,java.lang.String,int,int,javax.swing.KeyStroke,int)>/at.bestsolution.drawswf.MainWindow.getImagePath/0	<at.bestsolution.drawswf.MainWindow: java.lang.String getImagePath()>
<at.bestsolution.drawswf.menu.DrawToolsMenu: javax.swing.JRadioButtonMenuItem createMenuRadioButton(java.lang.String,java.lang.String,java.lang.String,int,int,javax.swing.KeyStroke,int)>/java.lang.StringBuffer.append/0	<java.lang.StringBuffer: java.lang.StringBuffer append(java.lang.String)>
<at.bestsolution.drawswf.menu.DrawToolsMenu: javax.swing.JRadioButtonMenuItem createMenuRadioButton(java.lang.String,java.lang.String,java.lang.String,int,int,javax.swing.KeyStroke,int)>/javax.swing.ImageIcon.<init>/0	<javax.swing.ImageIcon: void <init>(java.net.URL)>
<at.bestsolution.drawswf.menu.DrawToolsMenu: javax.swing.JRadioButtonMenuItem createMenuRadioButton(java.lang.String,java.lang.String,java.lang.String,int,int,javax.swing.KeyStroke,int)>/at.bestsolution.drawswf.MainWindow.getDrawingPanel/0	<at.bestsolution.drawswf.MainWindow: at.bestsolution.drawswf.DrawingPanel getDrawingPanel()>
<at.bestsolution.drawswf.menu.DrawToolsMenu: javax.swing.JRadioButtonMenuItem createMenuRadioButton(java.lang.String,java.lang.String,java.lang.String,int,int,javax.swing.KeyStroke,int)>/at.bestsolution.drawswf.actions.SetDrawingModeAction.<init>/0	<at.bestsolution.drawswf.actions.SetDrawingModeAction: void <init>(java.lang.String,java.lang.String,at.bestsolution.drawswf.DrawingPanel,int,int,javax.swing.KeyStroke,at.bestsolution.drawswf.MainWindow,int)>
<at.bestsolution.drawswf.menu.DrawToolsMenu: javax.swing.JRadioButtonMenuItem createMenuRadioButton(java.lang.String,java.lang.String,java.lang.String,int,int,javax.swing.KeyStroke,int)>/javax.swing.JRadioButtonMenuItem.<init>/0	<javax.swing.JRadioButtonMenuItem: void <init>(java.lang.String)>
<at.bestsolution.drawswf.menu.DrawToolsMenu: javax.swing.JRadioButtonMenuItem createMenuRadioButton(java.lang.String,java.lang.String,java.lang.String,int,int,javax.swing.KeyStroke,int)>/javax.swing.JRadioButtonMenuItem.setAction/0	<javax.swing.AbstractButton: void setAction(javax.swing.Action)>
<at.bestsolution.drawswf.menu.DrawToolsMenu: javax.swing.JRadioButtonMenuItem createMenuRadioButton(java.lang.String,java.lang.String,java.lang.String,int,int,javax.swing.KeyStroke,int)>/javax.swing.JRadioButtonMenuItem.setIcon/0	<javax.swing.AbstractButton: void setIcon(javax.swing.Icon)>
<at.bestsolution.drawswf.menu.DrawToolsMenu: void <init>(java.lang.String,char,at.bestsolution.drawswf.DrawObjectList)>/javax.swing.JMenu.<init>/0	<javax.swing.JMenu: void <init>(java.lang.String)>
<at.bestsolution.drawswf.menu.DrawToolsMenu: void <init>(java.lang.String,char,at.bestsolution.drawswf.DrawObjectList)>/at.bestsolution.drawswf.menu.DrawToolsMenu.setMnemonic/0	<javax.swing.AbstractButton: void setMnemonic(char)>
<at.bestsolution.drawswf.menu.DrawToolsMenu: void <init>(java.lang.String,char,at.bestsolution.drawswf.DrawObjectList)>/at.bestsolution.drawswf.menu.DrawToolsMenu.initMenu/0	<at.bestsolution.drawswf.menu.DrawToolsMenu: void initMenu()>
<at.bestsolution.drawswf.menu.DrawToolsMenu: void addDrawObject(javax.swing.JMenu,java.lang.String,java.lang.String,java.lang.String,int,javax.swing.KeyStroke,int)>/at.bestsolution.drawswf.menu.DrawToolsMenu.createMenuRadioButton/0	<at.bestsolution.drawswf.menu.DrawToolsMenu: javax.swing.JRadioButtonMenuItem createMenuRadioButton(java.lang.String,java.lang.String,java.lang.String,int,int,javax.swing.KeyStroke,int)>
<at.bestsolution.drawswf.menu.DrawToolsMenu: void addDrawObject(javax.swing.JMenu,java.lang.String,java.lang.String,java.lang.String,int,javax.swing.KeyStroke,int)>/javax.swing.JMenu.add/0	<javax.swing.JMenu: javax.swing.JMenuItem add(javax.swing.JMenuItem)>
<at.bestsolution.drawswf.menu.DrawToolsMenu: void addSetCanvasSizeAction(java.lang.String,java.lang.String,java.lang.String,int,javax.swing.KeyStroke)>/at.bestsolution.drawswf.MainWindow.getDrawingPanel/0	<at.bestsolution.drawswf.MainWindow: at.bestsolution.drawswf.DrawingPanel getDrawingPanel()>
<at.bestsolution.drawswf.menu.DrawToolsMenu: void addSetCanvasSizeAction(java.lang.String,java.lang.String,java.lang.String,int,javax.swing.KeyStroke)>/at.bestsolution.drawswf.actions.SetCanvasSizeAction.<init>/0	<at.bestsolution.drawswf.actions.SetCanvasSizeAction: void <init>(java.lang.String,java.lang.String,java.lang.String,at.bestsolution.drawswf.DrawingPanel,javax.swing.JFrame,int,javax.swing.KeyStroke)>
<at.bestsolution.drawswf.menu.DrawToolsMenu: void addSetCanvasSizeAction(java.lang.String,java.lang.String,java.lang.String,int,javax.swing.KeyStroke)>/at.bestsolution.drawswf.menu.DrawToolsMenu.add/0	<javax.swing.JMenu: javax.swing.JMenuItem add(javax.swing.Action)>
<at.bestsolution.drawswf.menu.DrawToolsMenu: void addSetColorAction(javax.swing.JMenu,java.lang.String,java.lang.String,java.lang.String,int,javax.swing.KeyStroke,java.lang.String,java.awt.Color,int)>/at.bestsolution.drawswf.IconProvider.getInstance/0	<at.bestsolution.drawswf.IconProvider: at.bestsolution.drawswf.IconProvider getInstance()>
<at.bestsolution.drawswf.menu.DrawToolsMenu: void addSetColorAction(javax.swing.JMenu,java.lang.String,java.lang.String,java.lang.String,int,javax.swing.KeyStroke,java.lang.String,java.awt.Color,int)>/at.bestsolution.ext.swing.AlphaColorJMenuItem.<init>/0	<at.bestsolution.ext.swing.AlphaColorJMenuItem: void <init>(at.bestsolution.ext.swing.icon.IIconFactory,java.lang.String,java.awt.Color)>
<at.bestsolution.drawswf.menu.DrawToolsMenu: void addSetColorAction(javax.swing.JMenu,java.lang.String,java.lang.String,java.lang.String,int,javax.swing.KeyStroke,java.lang.String,java.awt.Color,int)>/at.bestsolution.ext.swing.AlphaColorJMenuItem.setText/0	<javax.swing.AbstractButton: void setText(java.lang.String)>
<at.bestsolution.drawswf.menu.DrawToolsMenu: void addSetColorAction(javax.swing.JMenu,java.lang.String,java.lang.String,java.lang.String,int,javax.swing.KeyStroke,java.lang.String,java.awt.Color,int)>/at.bestsolution.ext.swing.AlphaColorJMenuItem.setToolTipText/0	<javax.swing.JComponent: void setToolTipText(java.lang.String)>
<at.bestsolution.drawswf.menu.DrawToolsMenu: void addSetColorAction(javax.swing.JMenu,java.lang.String,java.lang.String,java.lang.String,int,javax.swing.KeyStroke,java.lang.String,java.awt.Color,int)>/at.bestsolution.ext.swing.AlphaColorJMenuItem.setName/0	<java.awt.Component: void setName(java.lang.String)>
<at.bestsolution.drawswf.menu.DrawToolsMenu: void addSetColorAction(javax.swing.JMenu,java.lang.String,java.lang.String,java.lang.String,int,javax.swing.KeyStroke,java.lang.String,java.awt.Color,int)>/at.bestsolution.ext.swing.AlphaColorJMenuItem.setMnemonic/0	<javax.swing.AbstractButton: void setMnemonic(int)>
<at.bestsolution.drawswf.menu.DrawToolsMenu: void addSetColorAction(javax.swing.JMenu,java.lang.String,java.lang.String,java.lang.String,int,javax.swing.KeyStroke,java.lang.String,java.awt.Color,int)>/at.bestsolution.ext.swing.AlphaColorJMenuItem.setAccelerator/0	<javax.swing.JMenuItem: void setAccelerator(javax.swing.KeyStroke)>
<at.bestsolution.drawswf.menu.DrawToolsMenu: void addSetColorAction(javax.swing.JMenu,java.lang.String,java.lang.String,java.lang.String,int,javax.swing.KeyStroke,java.lang.String,java.awt.Color,int)>/at.bestsolution.drawswf.MainWindow.getDrawingPanel/0	<at.bestsolution.drawswf.MainWindow: at.bestsolution.drawswf.DrawingPanel getDrawingPanel()>
<at.bestsolution.drawswf.menu.DrawToolsMenu: void addSetColorAction(javax.swing.JMenu,java.lang.String,java.lang.String,java.lang.String,int,javax.swing.KeyStroke,java.lang.String,java.awt.Color,int)>/at.bestsolution.ext.swing.AlphaColorJMenuItem.addChangeListener/0	<javax.swing.AbstractButton: void addChangeListener(javax.swing.event.ChangeListener)>
<at.bestsolution.drawswf.menu.DrawToolsMenu: void addSetColorAction(javax.swing.JMenu,java.lang.String,java.lang.String,java.lang.String,int,javax.swing.KeyStroke,java.lang.String,java.awt.Color,int)>/javax.swing.JMenu.add/0	<javax.swing.JMenu: javax.swing.JMenuItem add(javax.swing.JMenuItem)>
<at.bestsolution.drawswf.menu.DrawToolsMenu: void addSetLineWidthAction(java.lang.String,java.lang.String,java.lang.String,int,javax.swing.KeyStroke)>/at.bestsolution.drawswf.MainWindow.getDrawingPanel/0	<at.bestsolution.drawswf.MainWindow: at.bestsolution.drawswf.DrawingPanel getDrawingPanel()>
<at.bestsolution.drawswf.menu.DrawToolsMenu: void addSetLineWidthAction(java.lang.String,java.lang.String,java.lang.String,int,javax.swing.KeyStroke)>/at.bestsolution.drawswf.actions.SetLineWidthAction.<init>/0	<at.bestsolution.drawswf.actions.SetLineWidthAction: void <init>(java.lang.String,java.lang.String,java.lang.String,at.bestsolution.drawswf.DrawingPanel,int,javax.swing.KeyStroke)>
<at.bestsolution.drawswf.menu.DrawToolsMenu: void addSetLineWidthAction(java.lang.String,java.lang.String,java.lang.String,int,javax.swing.KeyStroke)>/at.bestsolution.drawswf.menu.DrawToolsMenu.add/0	<javax.swing.JMenu: javax.swing.JMenuItem add(javax.swing.Action)>
<at.bestsolution.drawswf.menu.DrawToolsMenu: void initMenu()>/at.bestsolution.drawswf.MainWindow.getI18n/0	<at.bestsolution.drawswf.MainWindow: java.util.ResourceBundle getI18n()>
<at.bestsolution.drawswf.menu.DrawToolsMenu: void initMenu()>/javax.swing.JMenu.<init>/0	<javax.swing.JMenu: void <init>(java.lang.String)>
<at.bestsolution.drawswf.menu.DrawToolsMenu: void initMenu()>/javax.swing.JMenu.setMnemonic/0	<javax.swing.AbstractButton: void setMnemonic(char)>
<at.bestsolution.drawswf.menu.DrawToolsMenu: void initMenu()>/javax.swing.ButtonGroup.<init>/0	<javax.swing.ButtonGroup: void <init>()>
<at.bestsolution.drawswf.menu.DrawToolsMenu: void initMenu()>/at.bestsolution.drawswf.menu.DrawToolsMenu.addDrawObject/0	<at.bestsolution.drawswf.menu.DrawToolsMenu: void addDrawObject(javax.swing.JMenu,java.lang.String,java.lang.String,java.lang.String,int,javax.swing.KeyStroke,int)>
<at.bestsolution.drawswf.menu.DrawToolsMenu: void initMenu()>/javax.swing.ButtonGroup.add/0	<javax.swing.ButtonGroup: void add(javax.swing.AbstractButton)>
<at.bestsolution.drawswf.menu.DrawToolsMenu: void initMenu()>/javax.swing.JRadioButtonMenuItem.setSelected/0	<javax.swing.AbstractButton: void setSelected(boolean)>
<at.bestsolution.drawswf.menu.DrawToolsMenu: void initMenu()>/at.bestsolution.drawswf.menu.DrawToolsMenu.addDrawObject/1	<at.bestsolution.drawswf.menu.DrawToolsMenu: void addDrawObject(javax.swing.JMenu,java.lang.String,java.lang.String,java.lang.String,int,javax.swing.KeyStroke,int)>
<at.bestsolution.drawswf.menu.DrawToolsMenu: void initMenu()>/javax.swing.ButtonGroup.add/1	<javax.swing.ButtonGroup: void add(javax.swing.AbstractButton)>
<at.bestsolution.drawswf.menu.DrawToolsMenu: void initMenu()>/at.bestsolution.drawswf.menu.DrawToolsMenu.addDrawObject/2	<at.bestsolution.drawswf.menu.DrawToolsMenu: void addDrawObject(javax.swing.JMenu,java.lang.String,java.lang.String,java.lang.String,int,javax.swing.KeyStroke,int)>
<at.bestsolution.drawswf.menu.DrawToolsMenu: void initMenu()>/javax.swing.ButtonGroup.add/2	<javax.swing.ButtonGroup: void add(javax.swing.AbstractButton)>
<at.bestsolution.drawswf.menu.DrawToolsMenu: void initMenu()>/at.bestsolution.drawswf.menu.DrawToolsMenu.addDrawObject/3	<at.bestsolution.drawswf.menu.DrawToolsMenu: void addDrawObject(javax.swing.JMenu,java.lang.String,java.lang.String,java.lang.String,int,javax.swing.KeyStroke,int)>
<at.bestsolution.drawswf.menu.DrawToolsMenu: void initMenu()>/javax.swing.ButtonGroup.add/3	<javax.swing.ButtonGroup: void add(javax.swing.AbstractButton)>
<at.bestsolution.drawswf.menu.DrawToolsMenu: void initMenu()>/at.bestsolution.drawswf.menu.DrawToolsMenu.addDrawObject/4	<at.bestsolution.drawswf.menu.DrawToolsMenu: void addDrawObject(javax.swing.JMenu,java.lang.String,java.lang.String,java.lang.String,int,javax.swing.KeyStroke,int)>
<at.bestsolution.drawswf.menu.DrawToolsMenu: void initMenu()>/javax.swing.ButtonGroup.add/4	<javax.swing.ButtonGroup: void add(javax.swing.AbstractButton)>
<at.bestsolution.drawswf.menu.DrawToolsMenu: void initMenu()>/at.bestsolution.drawswf.menu.DrawToolsMenu.addDrawObject/5	<at.bestsolution.drawswf.menu.DrawToolsMenu: void addDrawObject(javax.swing.JMenu,java.lang.String,java.lang.String,java.lang.String,int,javax.swing.KeyStroke,int)>
<at.bestsolution.drawswf.menu.DrawToolsMenu: void initMenu()>/javax.swing.ButtonGroup.add/5	<javax.swing.ButtonGroup: void add(javax.swing.AbstractButton)>
<at.bestsolution.drawswf.menu.DrawToolsMenu: void initMenu()>/at.bestsolution.drawswf.menu.DrawToolsMenu.addDrawObject/6	<at.bestsolution.drawswf.menu.DrawToolsMenu: void addDrawObject(javax.swing.JMenu,java.lang.String,java.lang.String,java.lang.String,int,javax.swing.KeyStroke,int)>
<at.bestsolution.drawswf.menu.DrawToolsMenu: void initMenu()>/javax.swing.ButtonGroup.add/6	<javax.swing.ButtonGroup: void add(javax.swing.AbstractButton)>
<at.bestsolution.drawswf.menu.DrawToolsMenu: void initMenu()>/at.bestsolution.drawswf.menu.DrawToolsMenu.add/0	<javax.swing.JMenu: javax.swing.JMenuItem add(javax.swing.JMenuItem)>
<at.bestsolution.drawswf.menu.DrawToolsMenu: void initMenu()>/javax.swing.JMenu.<init>/1	<javax.swing.JMenu: void <init>(java.lang.String)>
<at.bestsolution.drawswf.menu.DrawToolsMenu: void initMenu()>/javax.swing.JMenu.setMnemonic/1	<javax.swing.AbstractButton: void setMnemonic(char)>
<at.bestsolution.drawswf.menu.DrawToolsMenu: void initMenu()>/at.bestsolution.drawswf.menu.DrawToolsMenu.addSetColorAction/0	<at.bestsolution.drawswf.menu.DrawToolsMenu: void addSetColorAction(javax.swing.JMenu,java.lang.String,java.lang.String,java.lang.String,int,javax.swing.KeyStroke,java.lang.String,java.awt.Color,int)>
<at.bestsolution.drawswf.menu.DrawToolsMenu: void initMenu()>/at.bestsolution.drawswf.menu.DrawToolsMenu.addSetColorAction/1	<at.bestsolution.drawswf.menu.DrawToolsMenu: void addSetColorAction(javax.swing.JMenu,java.lang.String,java.lang.String,java.lang.String,int,javax.swing.KeyStroke,java.lang.String,java.awt.Color,int)>
<at.bestsolution.drawswf.menu.DrawToolsMenu: void initMenu()>/at.bestsolution.drawswf.menu.DrawToolsMenu.add/1	<javax.swing.JMenu: javax.swing.JMenuItem add(javax.swing.JMenuItem)>
<at.bestsolution.drawswf.menu.DrawToolsMenu: void initMenu()>/at.bestsolution.drawswf.menu.DrawToolsMenu.addSetLineWidthAction/0	<at.bestsolution.drawswf.menu.DrawToolsMenu: void addSetLineWidthAction(java.lang.String,java.lang.String,java.lang.String,int,javax.swing.KeyStroke)>
<at.bestsolution.drawswf.menu.DrawToolsMenu: void initMenu()>/at.bestsolution.drawswf.menu.DrawToolsMenu.addSetCanvasSizeAction/0	<at.bestsolution.drawswf.menu.DrawToolsMenu: void addSetCanvasSizeAction(java.lang.String,java.lang.String,java.lang.String,int,javax.swing.KeyStroke)>
<at.bestsolution.drawswf.menu.DrawToolsMenu: void initMenu()>/at.bestsolution.drawswf.MainWindow.getDrawingPanel/0	<at.bestsolution.drawswf.MainWindow: at.bestsolution.drawswf.DrawingPanel getDrawingPanel()>
<at.bestsolution.drawswf.menu.DrawToolsMenu: void initMenu()>/at.bestsolution.drawswf.actions.ObjectListAction.<init>/0	<at.bestsolution.drawswf.actions.ObjectListAction: void <init>(java.lang.String,java.lang.String,java.lang.String,at.bestsolution.drawswf.DrawingPanel,int,at.bestsolution.drawswf.DrawObjectList)>
<at.bestsolution.drawswf.menu.DrawToolsMenu: void initMenu()>/at.bestsolution.drawswf.menu.DrawToolsMenu.add/2	<javax.swing.JMenu: javax.swing.JMenuItem add(javax.swing.Action)>
<at.bestsolution.drawswf.menu.DrawToolsMenu: void initMenu()>/at.bestsolution.drawswf.MainWindow.getDrawingPanel/1	<at.bestsolution.drawswf.MainWindow: at.bestsolution.drawswf.DrawingPanel getDrawingPanel()>
<at.bestsolution.drawswf.menu.DrawToolsMenu: void initMenu()>/at.bestsolution.drawswf.actions.OpenOptionsDialogAction.<init>/0	<at.bestsolution.drawswf.actions.OpenOptionsDialogAction: void <init>(java.lang.String,java.lang.String,java.lang.String,at.bestsolution.drawswf.DrawingPanel,int,javax.swing.KeyStroke)>
<at.bestsolution.drawswf.menu.DrawToolsMenu: void initMenu()>/at.bestsolution.drawswf.menu.DrawToolsMenu.add/3	<javax.swing.JMenu: javax.swing.JMenuItem add(javax.swing.Action)>
<at.bestsolution.drawswf.toolbar.DrawEditToolbar: void <init>()>/javax.swing.JToolBar.<init>/0	<javax.swing.JToolBar: void <init>()>
<at.bestsolution.drawswf.toolbar.DrawEditToolbar: void <init>()>/at.bestsolution.drawswf.toolbar.DrawEditToolbar.initToolbar/0	<at.bestsolution.drawswf.toolbar.DrawEditToolbar: void initToolbar()>
<at.bestsolution.drawswf.toolbar.DrawEditToolbar: void addClearAction(java.lang.String,java.lang.String,java.lang.String,int,javax.swing.KeyStroke)>/at.bestsolution.drawswf.MainWindow.getDrawingPanel/0	<at.bestsolution.drawswf.MainWindow: at.bestsolution.drawswf.DrawingPanel getDrawingPanel()>
<at.bestsolution.drawswf.toolbar.DrawEditToolbar: void addClearAction(java.lang.String,java.lang.String,java.lang.String,int,javax.swing.KeyStroke)>/at.bestsolution.drawswf.actions.ClearAction.<init>/0	<at.bestsolution.drawswf.actions.ClearAction: void <init>(java.lang.String,java.lang.String,at.bestsolution.drawswf.DrawingPanel)>
<at.bestsolution.drawswf.toolbar.DrawEditToolbar: void addClearAction(java.lang.String,java.lang.String,java.lang.String,int,javax.swing.KeyStroke)>/at.bestsolution.drawswf.toolbar.DrawEditToolbar.add/0	<javax.swing.JToolBar: javax.swing.JButton add(javax.swing.Action)>
<at.bestsolution.drawswf.toolbar.DrawEditToolbar: void addRedoAction(java.lang.String,java.lang.String,java.lang.String,int,javax.swing.KeyStroke)>/at.bestsolution.drawswf.MainWindow.getDrawingPanel/0	<at.bestsolution.drawswf.MainWindow: at.bestsolution.drawswf.DrawingPanel getDrawingPanel()>
<at.bestsolution.drawswf.toolbar.DrawEditToolbar: void addRedoAction(java.lang.String,java.lang.String,java.lang.String,int,javax.swing.KeyStroke)>/at.bestsolution.drawswf.actions.RedoAction.<init>/0	<at.bestsolution.drawswf.actions.RedoAction: void <init>(java.lang.String,java.lang.String,at.bestsolution.drawswf.DrawingPanel)>
<at.bestsolution.drawswf.toolbar.DrawEditToolbar: void addRedoAction(java.lang.String,java.lang.String,java.lang.String,int,javax.swing.KeyStroke)>/at.bestsolution.drawswf.toolbar.DrawEditToolbar.add/0	<javax.swing.JToolBar: javax.swing.JButton add(javax.swing.Action)>
<at.bestsolution.drawswf.toolbar.DrawEditToolbar: void addUndoAction(java.lang.String,java.lang.String,java.lang.String,int,javax.swing.KeyStroke)>/at.bestsolution.drawswf.MainWindow.getDrawingPanel/0	<at.bestsolution.drawswf.MainWindow: at.bestsolution.drawswf.DrawingPanel getDrawingPanel()>
<at.bestsolution.drawswf.toolbar.DrawEditToolbar: void addUndoAction(java.lang.String,java.lang.String,java.lang.String,int,javax.swing.KeyStroke)>/at.bestsolution.drawswf.actions.UndoAction.<init>/0	<at.bestsolution.drawswf.actions.UndoAction: void <init>(java.lang.String,java.lang.String,at.bestsolution.drawswf.DrawingPanel)>
<at.bestsolution.drawswf.toolbar.DrawEditToolbar: void addUndoAction(java.lang.String,java.lang.String,java.lang.String,int,javax.swing.KeyStroke)>/at.bestsolution.drawswf.toolbar.DrawEditToolbar.add/0	<javax.swing.JToolBar: javax.swing.JButton add(javax.swing.Action)>
<at.bestsolution.drawswf.toolbar.DrawEditToolbar: void initToolbar()>/at.bestsolution.drawswf.MainWindow.getI18n/0	<at.bestsolution.drawswf.MainWindow: java.util.ResourceBundle getI18n()>
<at.bestsolution.drawswf.toolbar.DrawEditToolbar: void initToolbar()>/javax.swing.KeyStroke.getKeyStroke/0	<javax.swing.KeyStroke: javax.swing.KeyStroke getKeyStroke(int,int)>
<at.bestsolution.drawswf.toolbar.DrawEditToolbar: void initToolbar()>/at.bestsolution.drawswf.toolbar.DrawEditToolbar.addUndoAction/0	<at.bestsolution.drawswf.toolbar.DrawEditToolbar: void addUndoAction(java.lang.String,java.lang.String,java.lang.String,int,javax.swing.KeyStroke)>
<at.bestsolution.drawswf.toolbar.DrawEditToolbar: void initToolbar()>/javax.swing.KeyStroke.getKeyStroke/1	<javax.swing.KeyStroke: javax.swing.KeyStroke getKeyStroke(int,int)>
<at.bestsolution.drawswf.toolbar.DrawEditToolbar: void initToolbar()>/at.bestsolution.drawswf.toolbar.DrawEditToolbar.addRedoAction/0	<at.bestsolution.drawswf.toolbar.DrawEditToolbar: void addRedoAction(java.lang.String,java.lang.String,java.lang.String,int,javax.swing.KeyStroke)>
<at.bestsolution.drawswf.toolbar.DrawEditToolbar: void initToolbar()>/javax.swing.KeyStroke.getKeyStroke/2	<javax.swing.KeyStroke: javax.swing.KeyStroke getKeyStroke(int,int)>
<at.bestsolution.drawswf.toolbar.DrawEditToolbar: void initToolbar()>/at.bestsolution.drawswf.toolbar.DrawEditToolbar.addClearAction/0	<at.bestsolution.drawswf.toolbar.DrawEditToolbar: void addClearAction(java.lang.String,java.lang.String,java.lang.String,int,javax.swing.KeyStroke)>
<at.bestsolution.drawswf.toolbar.DrawEditToolbar: void initToolbar()>/at.bestsolution.drawswf.toolbar.DrawEditToolbar.addSeparator/0	<javax.swing.JToolBar: void addSeparator()>
<at.bestsolution.drawswf.toolbar.DrawFileToolbar: void <init>()>/javax.swing.JToolBar.<init>/0	<javax.swing.JToolBar: void <init>()>
<at.bestsolution.drawswf.toolbar.DrawFileToolbar: void <init>()>/at.bestsolution.drawswf.toolbar.DrawFileToolbar.initToolbar/0	<at.bestsolution.drawswf.toolbar.DrawFileToolbar: void initToolbar()>
<at.bestsolution.drawswf.toolbar.DrawFileToolbar: void addFileAction(java.lang.String,java.lang.String,java.lang.String,boolean,int,javax.swing.KeyStroke,boolean)>/at.bestsolution.drawswf.MainWindow.getDrawingPanel/0	<at.bestsolution.drawswf.MainWindow: at.bestsolution.drawswf.DrawingPanel getDrawingPanel()>
<at.bestsolution.drawswf.toolbar.DrawFileToolbar: void addFileAction(java.lang.String,java.lang.String,java.lang.String,boolean,int,javax.swing.KeyStroke,boolean)>/at.bestsolution.drawswf.actions.FileAction.<init>/0	<at.bestsolution.drawswf.actions.FileAction: void <init>(java.lang.String,java.lang.String,at.bestsolution.drawswf.DrawingPanel,boolean,boolean)>
<at.bestsolution.drawswf.toolbar.DrawFileToolbar: void addFileAction(java.lang.String,java.lang.String,java.lang.String,boolean,int,javax.swing.KeyStroke,boolean)>/at.bestsolution.drawswf.toolbar.DrawFileToolbar.add/0	<javax.swing.JToolBar: javax.swing.JButton add(javax.swing.Action)>
<at.bestsolution.drawswf.toolbar.DrawFileToolbar: void addGraphicTemplateAction(java.lang.String,java.lang.String,java.lang.String,int,javax.swing.KeyStroke)>/at.bestsolution.drawswf.MainWindow.getDrawingPanel/0	<at.bestsolution.drawswf.MainWindow: at.bestsolution.drawswf.DrawingPanel getDrawingPanel()>
<at.bestsolution.drawswf.toolbar.DrawFileToolbar: void addGraphicTemplateAction(java.lang.String,java.lang.String,java.lang.String,int,javax.swing.KeyStroke)>/at.bestsolution.drawswf.actions.GraphicTemplateAction.<init>/0	<at.bestsolution.drawswf.actions.GraphicTemplateAction: void <init>(java.lang.String,java.lang.String,at.bestsolution.drawswf.DrawingPanel)>
<at.bestsolution.drawswf.toolbar.DrawFileToolbar: void addGraphicTemplateAction(java.lang.String,java.lang.String,java.lang.String,int,javax.swing.KeyStroke)>/at.bestsolution.drawswf.toolbar.DrawFileToolbar.add/0	<javax.swing.JToolBar: javax.swing.JButton add(javax.swing.Action)>
<at.bestsolution.drawswf.toolbar.DrawFileToolbar: void addSaveAction(java.lang.String,java.lang.String,java.lang.String,int,javax.swing.KeyStroke)>/at.bestsolution.drawswf.MainWindow.getDrawingPanel/0	<at.bestsolution.drawswf.MainWindow: at.bestsolution.drawswf.DrawingPanel getDrawingPanel()>
<at.bestsolution.drawswf.toolbar.DrawFileToolbar: void addSaveAction(java.lang.String,java.lang.String,java.lang.String,int,javax.swing.KeyStroke)>/at.bestsolution.drawswf.actions.SaveAction.<init>/0	<at.bestsolution.drawswf.actions.SaveAction: void <init>(java.lang.String,java.lang.String,at.bestsolution.drawswf.DrawingPanel)>
<at.bestsolution.drawswf.toolbar.DrawFileToolbar: void addSaveAction(java.lang.String,java.lang.String,java.lang.String,int,javax.swing.KeyStroke)>/at.bestsolution.drawswf.toolbar.DrawFileToolbar.add/0	<javax.swing.JToolBar: javax.swing.JButton add(javax.swing.Action)>
<at.bestsolution.drawswf.toolbar.DrawFileToolbar: void addSaveSWFAction(java.lang.String,java.lang.String,java.lang.String,int,javax.swing.KeyStroke)>/at.bestsolution.drawswf.MainWindow.getDrawingPanel/0	<at.bestsolution.drawswf.MainWindow: at.bestsolution.drawswf.DrawingPanel getDrawingPanel()>
<at.bestsolution.drawswf.toolbar.DrawFileToolbar: void addSaveSWFAction(java.lang.String,java.lang.String,java.lang.String,int,javax.swing.KeyStroke)>/at.bestsolution.drawswf.actions.SaveSWFAction.<init>/0	<at.bestsolution.drawswf.actions.SaveSWFAction: void <init>(java.lang.String,java.lang.String,at.bestsolution.drawswf.DrawingPanel)>
<at.bestsolution.drawswf.toolbar.DrawFileToolbar: void addSaveSWFAction(java.lang.String,java.lang.String,java.lang.String,int,javax.swing.KeyStroke)>/at.bestsolution.drawswf.toolbar.DrawFileToolbar.add/0	<javax.swing.JToolBar: javax.swing.JButton add(javax.swing.Action)>
<at.bestsolution.drawswf.toolbar.DrawFileToolbar: void initToolbar()>/at.bestsolution.drawswf.MainWindow.getI18n/0	<at.bestsolution.drawswf.MainWindow: java.util.ResourceBundle getI18n()>
<at.bestsolution.drawswf.toolbar.DrawFileToolbar: void initToolbar()>/javax.swing.KeyStroke.getKeyStroke/0	<javax.swing.KeyStroke: javax.swing.KeyStroke getKeyStroke(int,int)>
<at.bestsolution.drawswf.toolbar.DrawFileToolbar: void initToolbar()>/at.bestsolution.drawswf.toolbar.DrawFileToolbar.addFileAction/0	<at.bestsolution.drawswf.toolbar.DrawFileToolbar: void addFileAction(java.lang.String,java.lang.String,java.lang.String,boolean,int,javax.swing.KeyStroke,boolean)>
<at.bestsolution.drawswf.toolbar.DrawFileToolbar: void initToolbar()>/at.bestsolution.drawswf.toolbar.DrawFileToolbar.addFileAction/1	<at.bestsolution.drawswf.toolbar.DrawFileToolbar: void addFileAction(java.lang.String,java.lang.String,java.lang.String,boolean,int,javax.swing.KeyStroke,boolean)>
<at.bestsolution.drawswf.toolbar.DrawFileToolbar: void initToolbar()>/at.bestsolution.drawswf.toolbar.DrawFileToolbar.addFileAction/2	<at.bestsolution.drawswf.toolbar.DrawFileToolbar: void addFileAction(java.lang.String,java.lang.String,java.lang.String,boolean,int,javax.swing.KeyStroke,boolean)>
<at.bestsolution.drawswf.toolbar.DrawFileToolbar: void initToolbar()>/javax.swing.KeyStroke.getKeyStroke/1	<javax.swing.KeyStroke: javax.swing.KeyStroke getKeyStroke(int,int)>
<at.bestsolution.drawswf.toolbar.DrawFileToolbar: void initToolbar()>/at.bestsolution.drawswf.toolbar.DrawFileToolbar.addSaveAction/0	<at.bestsolution.drawswf.toolbar.DrawFileToolbar: void addSaveAction(java.lang.String,java.lang.String,java.lang.String,int,javax.swing.KeyStroke)>
<at.bestsolution.drawswf.toolbar.DrawFileToolbar: void initToolbar()>/at.bestsolution.drawswf.toolbar.DrawFileToolbar.addGraphicTemplateAction/0	<at.bestsolution.drawswf.toolbar.DrawFileToolbar: void addGraphicTemplateAction(java.lang.String,java.lang.String,java.lang.String,int,javax.swing.KeyStroke)>
<at.bestsolution.drawswf.toolbar.DrawFileToolbar: void initToolbar()>/javax.swing.KeyStroke.getKeyStroke/2	<javax.swing.KeyStroke: javax.swing.KeyStroke getKeyStroke(int,int)>
<at.bestsolution.drawswf.toolbar.DrawFileToolbar: void initToolbar()>/at.bestsolution.drawswf.toolbar.DrawFileToolbar.addSaveSWFAction/0	<at.bestsolution.drawswf.toolbar.DrawFileToolbar: void addSaveSWFAction(java.lang.String,java.lang.String,java.lang.String,int,javax.swing.KeyStroke)>
<at.bestsolution.drawswf.toolbar.DrawFileToolbar: void initToolbar()>/at.bestsolution.drawswf.toolbar.DrawFileToolbar.addSeparator/0	<javax.swing.JToolBar: void addSeparator()>
<at.bestsolution.drawswf.toolbar.DrawMovieToolbar: void <init>()>/javax.swing.JToolBar.<init>/0	<javax.swing.JToolBar: void <init>()>
<at.bestsolution.drawswf.toolbar.DrawMovieToolbar: void <init>()>/at.bestsolution.drawswf.toolbar.DrawMovieToolbar.initToolbar/0	<at.bestsolution.drawswf.toolbar.DrawMovieToolbar: void initToolbar()>
<at.bestsolution.drawswf.toolbar.DrawMovieToolbar: void addPlayAction(java.lang.String,java.lang.String,java.lang.String,int,javax.swing.KeyStroke,boolean)>/at.bestsolution.drawswf.MainWindow.getDrawingPanel/0	<at.bestsolution.drawswf.MainWindow: at.bestsolution.drawswf.DrawingPanel getDrawingPanel()>
<at.bestsolution.drawswf.toolbar.DrawMovieToolbar: void addPlayAction(java.lang.String,java.lang.String,java.lang.String,int,javax.swing.KeyStroke,boolean)>/at.bestsolution.drawswf.actions.PlayAction.<init>/0	<at.bestsolution.drawswf.actions.PlayAction: void <init>(java.lang.String,java.lang.String,at.bestsolution.drawswf.DrawingPanel,boolean)>
<at.bestsolution.drawswf.toolbar.DrawMovieToolbar: void addPlayAction(java.lang.String,java.lang.String,java.lang.String,int,javax.swing.KeyStroke,boolean)>/at.bestsolution.drawswf.toolbar.DrawMovieToolbar.add/0	<javax.swing.JToolBar: javax.swing.JButton add(javax.swing.Action)>
<at.bestsolution.drawswf.toolbar.DrawMovieToolbar: void initToolbar()>/at.bestsolution.drawswf.MainWindow.getI18n/0	<at.bestsolution.drawswf.MainWindow: java.util.ResourceBundle getI18n()>
<at.bestsolution.drawswf.toolbar.DrawMovieToolbar: void initToolbar()>/at.bestsolution.drawswf.toolbar.DrawMovieToolbar.addPlayAction/0	<at.bestsolution.drawswf.toolbar.DrawMovieToolbar: void addPlayAction(java.lang.String,java.lang.String,java.lang.String,int,javax.swing.KeyStroke,boolean)>
<at.bestsolution.drawswf.toolbar.DrawMovieToolbar: void initToolbar()>/at.bestsolution.drawswf.toolbar.DrawMovieToolbar.addPlayAction/1	<at.bestsolution.drawswf.toolbar.DrawMovieToolbar: void addPlayAction(java.lang.String,java.lang.String,java.lang.String,int,javax.swing.KeyStroke,boolean)>
<at.bestsolution.drawswf.toolbar.DrawMovieToolbar: void initToolbar()>/at.bestsolution.drawswf.toolbar.DrawMovieToolbar.addSeparator/0	<javax.swing.JToolBar: void addSeparator()>
<at.bestsolution.drawswf.toolbar.DrawToolsToolbar: javax.swing.JRadioButton createToolbarRadioButton(java.lang.String,java.lang.String,int,int)>/at.bestsolution.drawswf.MainWindow.getDrawingPanel/0	<at.bestsolution.drawswf.MainWindow: at.bestsolution.drawswf.DrawingPanel getDrawingPanel()>
<at.bestsolution.drawswf.toolbar.DrawToolsToolbar: javax.swing.JRadioButton createToolbarRadioButton(java.lang.String,java.lang.String,int,int)>/at.bestsolution.drawswf.actions.SetDrawingModeAction.<init>/0	<at.bestsolution.drawswf.actions.SetDrawingModeAction: void <init>(java.lang.String,at.bestsolution.drawswf.DrawingPanel,int,at.bestsolution.drawswf.MainWindow,int)>
<at.bestsolution.drawswf.toolbar.DrawToolsToolbar: javax.swing.JRadioButton createToolbarRadioButton(java.lang.String,java.lang.String,int,int)>/java.lang.Object.getClass/0	<java.lang.Object: java.lang.Class getClass()>
<at.bestsolution.drawswf.toolbar.DrawToolsToolbar: javax.swing.JRadioButton createToolbarRadioButton(java.lang.String,java.lang.String,int,int)>/java.lang.Class.getClassLoader/0	<java.lang.Class: java.lang.ClassLoader getClassLoader()>
<at.bestsolution.drawswf.toolbar.DrawToolsToolbar: javax.swing.JRadioButton createToolbarRadioButton(java.lang.String,java.lang.String,int,int)>/java.lang.StringBuffer.<init>/0	<java.lang.StringBuffer: void <init>()>
<at.bestsolution.drawswf.toolbar.DrawToolsToolbar: javax.swing.JRadioButton createToolbarRadioButton(java.lang.String,java.lang.String,int,int)>/at.bestsolution.drawswf.MainWindow.getImagePath/0	<at.bestsolution.drawswf.MainWindow: java.lang.String getImagePath()>
<at.bestsolution.drawswf.toolbar.DrawToolsToolbar: javax.swing.JRadioButton createToolbarRadioButton(java.lang.String,java.lang.String,int,int)>/java.lang.StringBuffer.append/0	<java.lang.StringBuffer: java.lang.StringBuffer append(java.lang.String)>
<at.bestsolution.drawswf.toolbar.DrawToolsToolbar: javax.swing.JRadioButton createToolbarRadioButton(java.lang.String,java.lang.String,int,int)>/javax.swing.ImageIcon.<init>/0	<javax.swing.ImageIcon: void <init>(java.net.URL)>
<at.bestsolution.drawswf.toolbar.DrawToolsToolbar: javax.swing.JRadioButton createToolbarRadioButton(java.lang.String,java.lang.String,int,int)>/javax.swing.JRadioButton.<init>/0	<javax.swing.JRadioButton: void <init>()>
<at.bestsolution.drawswf.toolbar.DrawToolsToolbar: javax.swing.JRadioButton createToolbarRadioButton(java.lang.String,java.lang.String,int,int)>/javax.swing.JRadioButton.setAction/0	<javax.swing.AbstractButton: void setAction(javax.swing.Action)>
<at.bestsolution.drawswf.toolbar.DrawToolsToolbar: javax.swing.JRadioButton createToolbarRadioButton(java.lang.String,java.lang.String,int,int)>/javax.swing.JRadioButton.setIcon/0	<javax.swing.AbstractButton: void setIcon(javax.swing.Icon)>
<at.bestsolution.drawswf.toolbar.DrawToolsToolbar: javax.swing.JRadioButton createToolbarRadioButton(java.lang.String,java.lang.String,int,int)>/java.lang.Object.getClass/1	<java.lang.Object: java.lang.Class getClass()>
<at.bestsolution.drawswf.toolbar.DrawToolsToolbar: javax.swing.JRadioButton createToolbarRadioButton(java.lang.String,java.lang.String,int,int)>/java.lang.Class.getClassLoader/1	<java.lang.Class: java.lang.ClassLoader getClassLoader()>
<at.bestsolution.drawswf.toolbar.DrawToolsToolbar: javax.swing.JRadioButton createToolbarRadioButton(java.lang.String,java.lang.String,int,int)>/java.lang.StringBuffer.<init>/1	<java.lang.StringBuffer: void <init>()>
<at.bestsolution.drawswf.toolbar.DrawToolsToolbar: javax.swing.JRadioButton createToolbarRadioButton(java.lang.String,java.lang.String,int,int)>/at.bestsolution.drawswf.MainWindow.getImagePath/1	<at.bestsolution.drawswf.MainWindow: java.lang.String getImagePath()>
<at.bestsolution.drawswf.toolbar.DrawToolsToolbar: javax.swing.JRadioButton createToolbarRadioButton(java.lang.String,java.lang.String,int,int)>/java.lang.StringBuffer.append/3	<java.lang.StringBuffer: java.lang.StringBuffer append(java.lang.String)>
<at.bestsolution.drawswf.toolbar.DrawToolsToolbar: javax.swing.JRadioButton createToolbarRadioButton(java.lang.String,java.lang.String,int,int)>/javax.swing.ImageIcon.<init>/1	<javax.swing.ImageIcon: void <init>(java.net.URL)>
<at.bestsolution.drawswf.toolbar.DrawToolsToolbar: javax.swing.JRadioButton createToolbarRadioButton(java.lang.String,java.lang.String,int,int)>/javax.swing.JRadioButton.setSelectedIcon/0	<javax.swing.AbstractButton: void setSelectedIcon(javax.swing.Icon)>
<at.bestsolution.drawswf.toolbar.DrawToolsToolbar: void <init>()>/javax.swing.JToolBar.<init>/0	<javax.swing.JToolBar: void <init>()>
<at.bestsolution.drawswf.toolbar.DrawToolsToolbar: void <init>()>/at.bestsolution.drawswf.toolbar.DrawToolsToolbar.initToolbar/0	<at.bestsolution.drawswf.toolbar.DrawToolsToolbar: void initToolbar()>
<at.bestsolution.drawswf.toolbar.DrawToolsToolbar: void addDrawObject(java.lang.String,java.lang.String,java.lang.String,int,javax.swing.KeyStroke,int)>/at.bestsolution.drawswf.toolbar.DrawToolsToolbar.createToolbarRadioButton/0	<at.bestsolution.drawswf.toolbar.DrawToolsToolbar: javax.swing.JRadioButton createToolbarRadioButton(java.lang.String,java.lang.String,int,int)>
<at.bestsolution.drawswf.toolbar.DrawToolsToolbar: void addDrawObject(java.lang.String,java.lang.String,java.lang.String,int,javax.swing.KeyStroke,int)>/at.bestsolution.drawswf.toolbar.DrawToolsToolbar.add/0	<java.awt.Container: java.awt.Component add(java.awt.Component)>
<at.bestsolution.drawswf.toolbar.DrawToolsToolbar: void addSetCanvasSizeAction(java.lang.String,java.lang.String,java.lang.String,int,javax.swing.KeyStroke)>/at.bestsolution.drawswf.MainWindow.getDrawingPanel/0	<at.bestsolution.drawswf.MainWindow: at.bestsolution.drawswf.DrawingPanel getDrawingPanel()>
<at.bestsolution.drawswf.toolbar.DrawToolsToolbar: void addSetCanvasSizeAction(java.lang.String,java.lang.String,java.lang.String,int,javax.swing.KeyStroke)>/at.bestsolution.drawswf.actions.SetCanvasSizeAction.<init>/0	<at.bestsolution.drawswf.actions.SetCanvasSizeAction: void <init>(java.lang.String,java.lang.String,at.bestsolution.drawswf.DrawingPanel,javax.swing.JFrame)>
<at.bestsolution.drawswf.toolbar.DrawToolsToolbar: void addSetCanvasSizeAction(java.lang.String,java.lang.String,java.lang.String,int,javax.swing.KeyStroke)>/at.bestsolution.drawswf.toolbar.DrawToolsToolbar.add/0	<javax.swing.JToolBar: javax.swing.JButton add(javax.swing.Action)>
<at.bestsolution.drawswf.toolbar.DrawToolsToolbar: void addSetColorAction(java.lang.String,java.lang.String,java.lang.String,int,javax.swing.KeyStroke,java.lang.String,java.awt.Color,int)>/at.bestsolution.drawswf.IconProvider.getInstance/0	<at.bestsolution.drawswf.IconProvider: at.bestsolution.drawswf.IconProvider getInstance()>
<at.bestsolution.drawswf.toolbar.DrawToolsToolbar: void addSetColorAction(java.lang.String,java.lang.String,java.lang.String,int,javax.swing.KeyStroke,java.lang.String,java.awt.Color,int)>/at.bestsolution.ext.swing.AlphaColorJButton.<init>/0	<at.bestsolution.ext.swing.AlphaColorJButton: void <init>(at.bestsolution.ext.swing.icon.IIconFactory,java.lang.String,java.awt.Color)>
<at.bestsolution.drawswf.toolbar.DrawToolsToolbar: void addSetColorAction(java.lang.String,java.lang.String,java.lang.String,int,javax.swing.KeyStroke,java.lang.String,java.awt.Color,int)>/at.bestsolution.ext.swing.AlphaColorJButton.setName/0	<java.awt.Component: void setName(java.lang.String)>
<at.bestsolution.drawswf.toolbar.DrawToolsToolbar: void addSetColorAction(java.lang.String,java.lang.String,java.lang.String,int,javax.swing.KeyStroke,java.lang.String,java.awt.Color,int)>/at.bestsolution.drawswf.MainWindow.getDrawingPanel/0	<at.bestsolution.drawswf.MainWindow: at.bestsolution.drawswf.DrawingPanel getDrawingPanel()>
<at.bestsolution.drawswf.toolbar.DrawToolsToolbar: void addSetColorAction(java.lang.String,java.lang.String,java.lang.String,int,javax.swing.KeyStroke,java.lang.String,java.awt.Color,int)>/at.bestsolution.ext.swing.AlphaColorJButton.addChangeListener/0	<javax.swing.AbstractButton: void addChangeListener(javax.swing.event.ChangeListener)>
<at.bestsolution.drawswf.toolbar.DrawToolsToolbar: void addSetColorAction(java.lang.String,java.lang.String,java.lang.String,int,javax.swing.KeyStroke,java.lang.String,java.awt.Color,int)>/at.bestsolution.ext.swing.AlphaColorJButton.setToolTipText/0	<javax.swing.JComponent: void setToolTipText(java.lang.String)>
<at.bestsolution.drawswf.toolbar.DrawToolsToolbar: void addSetColorAction(java.lang.String,java.lang.String,java.lang.String,int,javax.swing.KeyStroke,java.lang.String,java.awt.Color,int)>/at.bestsolution.drawswf.toolbar.DrawToolsToolbar.add/0	<java.awt.Container: java.awt.Component add(java.awt.Component)>
<at.bestsolution.drawswf.toolbar.DrawToolsToolbar: void addSetLineWidthAction(java.lang.String,java.lang.String,java.lang.String,int,javax.swing.KeyStroke)>/at.bestsolution.drawswf.MainWindow.getDrawingPanel/0	<at.bestsolution.drawswf.MainWindow: at.bestsolution.drawswf.DrawingPanel getDrawingPanel()>
<at.bestsolution.drawswf.toolbar.DrawToolsToolbar: void addSetLineWidthAction(java.lang.String,java.lang.String,java.lang.String,int,javax.swing.KeyStroke)>/at.bestsolution.drawswf.actions.SetLineWidthAction.<init>/0	<at.bestsolution.drawswf.actions.SetLineWidthAction: void <init>(java.lang.String,java.lang.String,at.bestsolution.drawswf.DrawingPanel)>
<at.bestsolution.drawswf.toolbar.DrawToolsToolbar: void addSetLineWidthAction(java.lang.String,java.lang.String,java.lang.String,int,javax.swing.KeyStroke)>/at.bestsolution.drawswf.toolbar.DrawToolsToolbar.add/0	<javax.swing.JToolBar: javax.swing.JButton add(javax.swing.Action)>
<at.bestsolution.drawswf.toolbar.DrawToolsToolbar: void initToolbar()>/at.bestsolution.drawswf.MainWindow.getI18n/0	<at.bestsolution.drawswf.MainWindow: java.util.ResourceBundle getI18n()>
<at.bestsolution.drawswf.toolbar.DrawToolsToolbar: void initToolbar()>/javax.swing.ButtonGroup.<init>/0	<javax.swing.ButtonGroup: void <init>()>
<at.bestsolution.drawswf.toolbar.DrawToolsToolbar: void initToolbar()>/at.bestsolution.drawswf.toolbar.DrawToolsToolbar.addDrawObject/0	<at.bestsolution.drawswf.toolbar.DrawToolsToolbar: void addDrawObject(java.lang.String,java.lang.String,java.lang.String,int,javax.swing.KeyStroke,int)>
<at.bestsolution.drawswf.toolbar.DrawToolsToolbar: void initToolbar()>/javax.swing.ButtonGroup.add/0	<javax.swing.ButtonGroup: void add(javax.swing.AbstractButton)>
<at.bestsolution.drawswf.toolbar.DrawToolsToolbar: void initToolbar()>/javax.swing.JRadioButton.setSelected/0	<javax.swing.AbstractButton: void setSelected(boolean)>
<at.bestsolution.drawswf.toolbar.DrawToolsToolbar: void initToolbar()>/at.bestsolution.drawswf.toolbar.DrawToolsToolbar.addDrawObject/1	<at.bestsolution.drawswf.toolbar.DrawToolsToolbar: void addDrawObject(java.lang.String,java.lang.String,java.lang.String,int,javax.swing.KeyStroke,int)>
<at.bestsolution.drawswf.toolbar.DrawToolsToolbar: void initToolbar()>/javax.swing.ButtonGroup.add/1	<javax.swing.ButtonGroup: void add(javax.swing.AbstractButton)>
<at.bestsolution.drawswf.toolbar.DrawToolsToolbar: void initToolbar()>/at.bestsolution.drawswf.toolbar.DrawToolsToolbar.addDrawObject/2	<at.bestsolution.drawswf.toolbar.DrawToolsToolbar: void addDrawObject(java.lang.String,java.lang.String,java.lang.String,int,javax.swing.KeyStroke,int)>
<at.bestsolution.drawswf.toolbar.DrawToolsToolbar: void initToolbar()>/javax.swing.ButtonGroup.add/2	<javax.swing.ButtonGroup: void add(javax.swing.AbstractButton)>
<at.bestsolution.drawswf.toolbar.DrawToolsToolbar: void initToolbar()>/at.bestsolution.drawswf.toolbar.DrawToolsToolbar.addDrawObject/3	<at.bestsolution.drawswf.toolbar.DrawToolsToolbar: void addDrawObject(java.lang.String,java.lang.String,java.lang.String,int,javax.swing.KeyStroke,int)>
<at.bestsolution.drawswf.toolbar.DrawToolsToolbar: void initToolbar()>/javax.swing.ButtonGroup.add/3	<javax.swing.ButtonGroup: void add(javax.swing.AbstractButton)>
<at.bestsolution.drawswf.toolbar.DrawToolsToolbar: void initToolbar()>/at.bestsolution.drawswf.toolbar.DrawToolsToolbar.addDrawObject/4	<at.bestsolution.drawswf.toolbar.DrawToolsToolbar: void addDrawObject(java.lang.String,java.lang.String,java.lang.String,int,javax.swing.KeyStroke,int)>
<at.bestsolution.drawswf.toolbar.DrawToolsToolbar: void initToolbar()>/javax.swing.ButtonGroup.add/4	<javax.swing.ButtonGroup: void add(javax.swing.AbstractButton)>
<at.bestsolution.drawswf.toolbar.DrawToolsToolbar: void initToolbar()>/at.bestsolution.drawswf.toolbar.DrawToolsToolbar.addDrawObject/5	<at.bestsolution.drawswf.toolbar.DrawToolsToolbar: void addDrawObject(java.lang.String,java.lang.String,java.lang.String,int,javax.swing.KeyStroke,int)>
<at.bestsolution.drawswf.toolbar.DrawToolsToolbar: void initToolbar()>/javax.swing.ButtonGroup.add/5	<javax.swing.ButtonGroup: void add(javax.swing.AbstractButton)>
<at.bestsolution.drawswf.toolbar.DrawToolsToolbar: void initToolbar()>/at.bestsolution.drawswf.toolbar.DrawToolsToolbar.addDrawObject/6	<at.bestsolution.drawswf.toolbar.DrawToolsToolbar: void addDrawObject(java.lang.String,java.lang.String,java.lang.String,int,javax.swing.KeyStroke,int)>
<at.bestsolution.drawswf.toolbar.DrawToolsToolbar: void initToolbar()>/javax.swing.ButtonGroup.add/6	<javax.swing.ButtonGroup: void add(javax.swing.AbstractButton)>
<at.bestsolution.drawswf.toolbar.DrawToolsToolbar: void initToolbar()>/at.bestsolution.drawswf.toolbar.DrawToolsToolbar.addSeparator/0	<javax.swing.JToolBar: void addSeparator()>
<at.bestsolution.drawswf.toolbar.DrawToolsToolbar: void initToolbar()>/at.bestsolution.drawswf.toolbar.DrawToolsToolbar.addSetColorAction/0	<at.bestsolution.drawswf.toolbar.DrawToolsToolbar: void addSetColorAction(java.lang.String,java.lang.String,java.lang.String,int,javax.swing.KeyStroke,java.lang.String,java.awt.Color,int)>
<at.bestsolution.drawswf.toolbar.DrawToolsToolbar: void initToolbar()>/at.bestsolution.drawswf.toolbar.DrawToolsToolbar.addSetColorAction/1	<at.bestsolution.drawswf.toolbar.DrawToolsToolbar: void addSetColorAction(java.lang.String,java.lang.String,java.lang.String,int,javax.swing.KeyStroke,java.lang.String,java.awt.Color,int)>
<at.bestsolution.drawswf.toolbar.DrawToolsToolbar: void initToolbar()>/at.bestsolution.drawswf.toolbar.DrawToolsToolbar.addSeparator/1	<javax.swing.JToolBar: void addSeparator()>
<at.bestsolution.drawswf.toolbar.DrawToolsToolbar: void initToolbar()>/at.bestsolution.drawswf.toolbar.DrawToolsToolbar.addSetLineWidthAction/0	<at.bestsolution.drawswf.toolbar.DrawToolsToolbar: void addSetLineWidthAction(java.lang.String,java.lang.String,java.lang.String,int,javax.swing.KeyStroke)>
<at.bestsolution.drawswf.toolbar.DrawToolsToolbar: void initToolbar()>/at.bestsolution.drawswf.toolbar.DrawToolsToolbar.addSetCanvasSizeAction/0	<at.bestsolution.drawswf.toolbar.DrawToolsToolbar: void addSetCanvasSizeAction(java.lang.String,java.lang.String,java.lang.String,int,javax.swing.KeyStroke)>
<at.bestsolution.drawswf.toolbar.DrawToolsToolbar: void initToolbar()>/at.bestsolution.drawswf.MainWindow.getDrawingPanel/0	<at.bestsolution.drawswf.MainWindow: at.bestsolution.drawswf.DrawingPanel getDrawingPanel()>
<at.bestsolution.drawswf.toolbar.DrawToolsToolbar: void initToolbar()>/at.bestsolution.drawswf.actions.ObjectListAction.<init>/0	<at.bestsolution.drawswf.actions.ObjectListAction: void <init>(java.lang.String,java.lang.String,java.lang.String,at.bestsolution.drawswf.DrawingPanel,int,at.bestsolution.drawswf.DrawObjectList)>
<at.bestsolution.drawswf.toolbar.DrawToolsToolbar: void initToolbar()>/at.bestsolution.drawswf.toolbar.DrawToolsToolbar.addSeparator/2	<javax.swing.JToolBar: void addSeparator()>
<at.bestsolution.drawswf.util.DrawSWFConfig: at.bestsolution.drawswf.util.DrawSWFConfig getInstance()>/at.bestsolution.drawswf.util.DrawSWFConfig.<init>/0	<at.bestsolution.drawswf.util.DrawSWFConfig: void <init>()>
<at.bestsolution.drawswf.util.DrawSWFConfig: at.bestsolution.drawswf.util.DrawSWFConfig getInstance()>/at.bestsolution.drawswf.util.DrawSWFConfig.loadConfig/0	<at.bestsolution.drawswf.util.DrawSWFConfig: void loadConfig()>
<at.bestsolution.drawswf.util.DrawSWFConfig: void <init>()>/at.bestsolution.util.BestsolutionConfiguration.<init>/0	<at.bestsolution.util.BestsolutionConfiguration: void <init>()>
<at.bestsolution.drawswf.util.DrawSWFConfig: void loadConfig()>/java.lang.Object.getClass/0	<java.lang.Object: java.lang.Class getClass()>
<at.bestsolution.drawswf.util.DrawSWFConfig: void loadConfig()>/java.lang.Class.getClassLoader/0	<java.lang.Class: java.lang.ClassLoader getClassLoader()>
<at.bestsolution.drawswf.util.DrawSWFConfig: void loadConfig()>/java.lang.StringBuffer.<init>/0	<java.lang.StringBuffer: void <init>()>
<at.bestsolution.drawswf.util.DrawSWFConfig: void loadConfig()>/java.lang.System.getProperty/0	<java.lang.System: java.lang.String getProperty(java.lang.String)>
<at.bestsolution.drawswf.util.DrawSWFConfig: void loadConfig()>/java.lang.StringBuffer.append/0	<java.lang.StringBuffer: java.lang.StringBuffer append(java.lang.String)>
<at.bestsolution.drawswf.util.DrawSWFConfig: void loadConfig()>/at.bestsolution.drawswf.util.DrawSWFConfig.loadConfig/0	<at.bestsolution.util.BestsolutionConfiguration: void loadConfig(java.io.InputStream,java.lang.String)>
<at.bestsolution.drawswf.util.DrawSWFConfig: void loadConfig()>/at.bestsolution.drawswf.util.DrawSWFConfig.getProperty/0	<at.bestsolution.util.BestsolutionConfiguration: java.lang.String getProperty(java.lang.String)>
<at.bestsolution.drawswf.util.DrawSWFConfig: void loadConfig()>/java.lang.StringBuffer.<init>/1	<java.lang.StringBuffer: void <init>()>
<at.bestsolution.drawswf.util.DrawSWFConfig: void loadConfig()>/java.lang.System.getProperty/1	<java.lang.System: java.lang.String getProperty(java.lang.String)>
<at.bestsolution.drawswf.util.DrawSWFConfig: void loadConfig()>/java.lang.StringBuffer.append/5	<java.lang.StringBuffer: java.lang.StringBuffer append(java.lang.String)>
<at.bestsolution.drawswf.util.DrawSWFConfig: void loadConfig()>/java.io.File.<init>/0	<java.io.File: void <init>(java.lang.String)>
<at.bestsolution.drawswf.util.DrawSWFConfig: void loadConfig()>/java.io.File.exists/0	<java.io.File: boolean exists()>
<at.bestsolution.drawswf.util.DrawSWFConfig: void loadConfig()>/java.io.File.mkdirs/0	<java.io.File: boolean mkdirs()>
<at.bestsolution.drawswf.util.DrawSWFConfig: void loadConfig()>/java.lang.StringBuffer.<init>/2	<java.lang.StringBuffer: void <init>()>
<at.bestsolution.drawswf.util.DrawSWFConfig: void loadConfig()>/java.lang.System.getProperty/2	<java.lang.System: java.lang.String getProperty(java.lang.String)>
<at.bestsolution.drawswf.util.DrawSWFConfig: void loadConfig()>/java.lang.StringBuffer.append/10	<java.lang.StringBuffer: java.lang.StringBuffer append(java.lang.String)>
<at.bestsolution.drawswf.util.DrawSWFConfig: void loadConfig()>/at.bestsolution.drawswf.util.DrawSWFConfig.setProperty/0	<at.bestsolution.util.BestsolutionConfiguration: void setProperty(java.lang.String,java.lang.String)>
<at.bestsolution.ext.awt.FontLoader$1: void <init>(at.bestsolution.ext.awt.FontLoader)>/java.lang.Object.<init>/0	<java.lang.Object: void <init>()>
<at.bestsolution.ext.awt.FontLoader: at.bestsolution.ext.awt.FontLoader getInstance()>/at.bestsolution.ext.awt.FontLoader.<init>/0	<at.bestsolution.ext.awt.FontLoader: void <init>()>
<at.bestsolution.ext.awt.FontLoader: void <init>()>/java.lang.Object.<init>/0	<java.lang.Object: void <init>()>
<at.bestsolution.ext.awt.FontLoader: void <init>()>/java.util.TreeMap.<init>/0	<java.util.TreeMap: void <init>()>
<at.bestsolution.ext.awt.FontLoader: void <init>()>/at.bestsolution.ext.awt.FontLoader.loadStandardFonts/0	<at.bestsolution.ext.awt.FontLoader: void loadStandardFonts()>
<at.bestsolution.ext.awt.FontLoader: void addAdditionalPath(java.lang.String)>/at.bestsolution.ext.awt.FontLoader.loadAdditionalFonts/0	<at.bestsolution.ext.awt.FontLoader: void loadAdditionalFonts(java.lang.String)>
<at.bestsolution.ext.awt.FontLoader: void loadAdditionalFonts(java.lang.String)>/at.bestsolution.ext.awt.FontLoader$1.<init>/0	<at.bestsolution.ext.awt.FontLoader$1: void <init>(at.bestsolution.ext.awt.FontLoader)>
<at.bestsolution.ext.awt.FontLoader: void loadAdditionalFonts(java.lang.String)>/java.io.File.<init>/0	<java.io.File: void <init>(java.lang.String)>
<at.bestsolution.ext.awt.FontLoader: void loadAdditionalFonts(java.lang.String)>/java.io.File.listFiles/0	<java.io.File: java.io.File[] listFiles(java.io.FileFilter)>
<at.bestsolution.ext.awt.FontLoader: void loadAdditionalFonts(java.lang.String)>/java.io.FileInputStream.<init>/0	<java.io.FileInputStream: void <init>(java.io.File)>
<at.bestsolution.ext.awt.FontLoader: void loadAdditionalFonts(java.lang.String)>/java.awt.Font.createFont/0	<java.awt.Font: java.awt.Font createFont(int,java.io.InputStream)>
<at.bestsolution.ext.awt.FontLoader: void loadAdditionalFonts(java.lang.String)>/java.util.TreeMap.put/0	<java.util.TreeMap: java.lang.Object put(java.lang.Object,java.lang.Object)>
<at.bestsolution.ext.awt.FontLoader: void loadAdditionalFonts(java.lang.String)>/java.io.FileInputStream.close/0	<java.io.FileInputStream: void close()>
<at.bestsolution.ext.awt.FontLoader: void loadStandardFonts()>/java.awt.GraphicsEnvironment.getLocalGraphicsEnvironment/0	<java.awt.GraphicsEnvironment: java.awt.GraphicsEnvironment getLocalGraphicsEnvironment()>
<at.bestsolution.ext.awt.FontLoader: void loadStandardFonts()>/java.util.TreeMap.put/0	<java.util.TreeMap: java.lang.Object put(java.lang.Object,java.lang.Object)>
<at.bestsolution.ext.swing.AlphaColorJButton: void <init>(at.bestsolution.ext.swing.icon.IIconFactory,java.lang.String)>/javax.swing.JButton.<init>/0	<javax.swing.JButton: void <init>()>
<at.bestsolution.ext.swing.AlphaColorJButton: void <init>(at.bestsolution.ext.swing.icon.IIconFactory,java.lang.String)>/at.bestsolution.ext.swing.icon.IIconFactory.getSolidColorIcon/0	<at.bestsolution.drawswf.IconProvider: at.bestsolution.ext.swing.icon.SolidColoredIcon getSolidColorIcon(java.lang.String)>
<at.bestsolution.ext.swing.AlphaColorJButton: void <init>(at.bestsolution.ext.swing.icon.IIconFactory,java.lang.String)>/at.bestsolution.ext.swing.AlphaColorJButton.setIcon/0	<javax.swing.AbstractButton: void setIcon(javax.swing.Icon)>
<at.bestsolution.ext.swing.AlphaColorJButton: void <init>(at.bestsolution.ext.swing.icon.IIconFactory,java.lang.String)>/at.bestsolution.ext.swing.AlphaColorJButton.addActionListener/0	<javax.swing.AbstractButton: void addActionListener(java.awt.event.ActionListener)>
<at.bestsolution.ext.swing.AlphaColorJButton: void <init>(at.bestsolution.ext.swing.icon.IIconFactory,java.lang.String,java.awt.Color)>/at.bestsolution.ext.swing.AlphaColorJButton.<init>/0	<at.bestsolution.ext.swing.AlphaColorJButton: void <init>(at.bestsolution.ext.swing.icon.IIconFactory,java.lang.String)>
<at.bestsolution.ext.swing.AlphaColorJMenuItem: void <init>(at.bestsolution.ext.swing.icon.IIconFactory,java.lang.String,java.awt.Color)>/javax.swing.JMenuItem.<init>/0	<javax.swing.JMenuItem: void <init>()>
<at.bestsolution.ext.swing.AlphaColorJMenuItem: void <init>(at.bestsolution.ext.swing.icon.IIconFactory,java.lang.String,java.awt.Color)>/at.bestsolution.ext.swing.icon.IIconFactory.getSolidColorIcon/0	<at.bestsolution.drawswf.IconProvider: at.bestsolution.ext.swing.icon.SolidColoredIcon getSolidColorIcon(java.lang.String)>
<at.bestsolution.ext.swing.AlphaColorJMenuItem: void <init>(at.bestsolution.ext.swing.icon.IIconFactory,java.lang.String,java.awt.Color)>/at.bestsolution.ext.swing.AlphaColorJMenuItem.setIcon/0	<javax.swing.AbstractButton: void setIcon(javax.swing.Icon)>
<at.bestsolution.ext.swing.AlphaColorJMenuItem: void <init>(at.bestsolution.ext.swing.icon.IIconFactory,java.lang.String,java.awt.Color)>/at.bestsolution.ext.swing.AlphaColorJMenuItem.addActionListener/0	<javax.swing.AbstractButton: void addActionListener(java.awt.event.ActionListener)>
<at.bestsolution.ext.swing.dialog.JGradientChooser: void <clinit>()>/java.awt.geom.Point2D$Float.<init>/0	<java.awt.geom.Point2D$Float: void <init>(float,float)>
<at.bestsolution.ext.swing.dialog.JGradientChooser: void <clinit>()>/java.awt.geom.Point2D$Float.<init>/1	<java.awt.geom.Point2D$Float: void <init>(float,float)>
<at.bestsolution.ext.swing.dialog.JGradientChooser: void <clinit>()>/java.awt.geom.Point2D$Float.<init>/2	<java.awt.geom.Point2D$Float: void <init>(float,float)>
<at.bestsolution.ext.swing.icon.GradientIcon: java.lang.Class class$(java.lang.String)>/java.lang.Class.forName/0	<java.lang.Class: java.lang.Class forName(java.lang.String)>
<at.bestsolution.ext.swing.icon.GradientIcon: java.lang.Class class$(java.lang.String)>/java.lang.NoClassDefFoundError.<init>/0	<java.lang.NoClassDefFoundError: void <init>()>
<at.bestsolution.ext.swing.icon.GradientIcon: java.lang.Class class$(java.lang.String)>/java.lang.NoClassDefFoundError.initCause/0	<java.lang.Throwable: java.lang.Throwable initCause(java.lang.Throwable)>
<at.bestsolution.ext.swing.icon.GradientIcon: void <init>(org.apache.batik.ext.awt.MultipleGradientPaint,int,int,int,int)>/java.lang.Object.<init>/0	<java.lang.Object: void <init>()>
<at.bestsolution.ext.swing.icon.GradientIcon: void <init>(org.apache.batik.ext.awt.MultipleGradientPaint,int,int,int,int)>/javax.swing.event.EventListenerList.<init>/0	<javax.swing.event.EventListenerList: void <init>()>
<at.bestsolution.ext.swing.icon.GradientIcon: void <init>(org.apache.batik.ext.awt.MultipleGradientPaint,int,int,int,int)>/java.awt.geom.Point2D$Float.<init>/0	<java.awt.geom.Point2D$Float: void <init>(float,float)>
<at.bestsolution.ext.swing.icon.GradientIcon: void <init>(org.apache.batik.ext.awt.MultipleGradientPaint,int,int,int,int)>/java.awt.geom.Point2D$Float.<init>/1	<java.awt.geom.Point2D$Float: void <init>(float,float)>
<at.bestsolution.ext.swing.icon.GradientIcon: void <init>(org.apache.batik.ext.awt.MultipleGradientPaint,int,int,int,int)>/java.awt.geom.Point2D$Float.<init>/2	<java.awt.geom.Point2D$Float: void <init>(float,float)>
<at.bestsolution.ext.swing.icon.GradientIcon: void <init>(org.apache.batik.ext.awt.MultipleGradientPaint,int,int,int,int)>/at.bestsolution.ext.swing.icon.GradientIcon.setGradient/0	<at.bestsolution.ext.swing.icon.GradientIcon: void setGradient(org.apache.batik.ext.awt.MultipleGradientPaint)>
<at.bestsolution.ext.swing.icon.GradientIcon: void fireStateChanged()>/javax.swing.event.EventListenerList.getListenerList/0	<javax.swing.event.EventListenerList: java.lang.Object[] getListenerList()>
<at.bestsolution.ext.swing.icon.GradientIcon: void fireStateChanged()>/at.bestsolution.ext.swing.icon.GradientIcon.class$/0	<at.bestsolution.ext.swing.icon.GradientIcon: java.lang.Class class$(java.lang.String)>
<at.bestsolution.ext.swing.icon.GradientIcon: void fireStateChanged()>/javax.swing.event.ChangeEvent.<init>/0	<javax.swing.event.ChangeEvent: void <init>(java.lang.Object)>
<at.bestsolution.ext.swing.icon.GradientIcon: void setGradient(org.apache.batik.ext.awt.MultipleGradientPaint)>/at.bestsolution.ext.swing.icon.GradientIcon.fireStateChanged/0	<at.bestsolution.ext.swing.icon.GradientIcon: void fireStateChanged()>
<at.bestsolution.ext.swing.icon.SolidColoredIcon: java.lang.Class class$(java.lang.String)>/java.lang.Class.forName/0	<java.lang.Class: java.lang.Class forName(java.lang.String)>
<at.bestsolution.ext.swing.icon.SolidColoredIcon: java.lang.Class class$(java.lang.String)>/java.lang.NoClassDefFoundError.<init>/0	<java.lang.NoClassDefFoundError: void <init>()>
<at.bestsolution.ext.swing.icon.SolidColoredIcon: java.lang.Class class$(java.lang.String)>/java.lang.NoClassDefFoundError.initCause/0	<java.lang.Throwable: java.lang.Throwable initCause(java.lang.Throwable)>
<at.bestsolution.ext.swing.icon.SolidColoredIcon: void <init>(java.awt.Color,int,int,int,int)>/java.lang.Object.<init>/0	<java.lang.Object: void <init>()>
<at.bestsolution.ext.swing.icon.SolidColoredIcon: void <init>(java.awt.Color,int,int,int,int)>/javax.swing.event.EventListenerList.<init>/0	<javax.swing.event.EventListenerList: void <init>()>
<at.bestsolution.ext.swing.icon.SolidColoredIcon: void <init>(java.awt.Color,int,int,int,int)>/at.bestsolution.ext.swing.icon.SolidColoredIcon.setFillColor/0	<at.bestsolution.ext.swing.icon.SolidColoredIcon: void setFillColor(java.awt.Color)>
<at.bestsolution.ext.swing.icon.SolidColoredIcon: void fireStateChanged()>/javax.swing.event.EventListenerList.getListenerList/0	<javax.swing.event.EventListenerList: java.lang.Object[] getListenerList()>
<at.bestsolution.ext.swing.icon.SolidColoredIcon: void fireStateChanged()>/at.bestsolution.ext.swing.icon.SolidColoredIcon.class$/0	<at.bestsolution.ext.swing.icon.SolidColoredIcon: java.lang.Class class$(java.lang.String)>
<at.bestsolution.ext.swing.icon.SolidColoredIcon: void fireStateChanged()>/javax.swing.event.ChangeEvent.<init>/0	<javax.swing.event.ChangeEvent: void <init>(java.lang.Object)>
<at.bestsolution.ext.swing.icon.SolidColoredIcon: void setFillColor(java.awt.Color)>/java.awt.Color.<init>/0	<java.awt.Color: void <init>(int,int,int)>
<at.bestsolution.ext.swing.icon.SolidColoredIcon: void setFillColor(java.awt.Color)>/at.bestsolution.ext.swing.icon.SolidColoredIcon.fireStateChanged/0	<at.bestsolution.ext.swing.icon.SolidColoredIcon: void fireStateChanged()>
<at.bestsolution.util.BestsolutionConfiguration: java.lang.String getProperty(java.lang.String)>/java.util.Properties.getProperty/0	<java.util.Properties: java.lang.String getProperty(java.lang.String)>
<at.bestsolution.util.BestsolutionConfiguration: void <init>()>/java.lang.Object.<init>/0	<java.lang.Object: void <init>()>
<at.bestsolution.util.BestsolutionConfiguration: void loadConfig(java.io.InputStream,java.lang.String)>/java.util.Properties.<init>/0	<java.util.Properties: void <init>()>
<at.bestsolution.util.BestsolutionConfiguration: void loadConfig(java.io.InputStream,java.lang.String)>/java.util.Properties.load/0	<java.util.Properties: void load(java.io.InputStream)>
<at.bestsolution.util.BestsolutionConfiguration: void loadConfig(java.io.InputStream,java.lang.String)>/java.io.File.<init>/0	<java.io.File: void <init>(java.lang.String)>
<at.bestsolution.util.BestsolutionConfiguration: void loadConfig(java.io.InputStream,java.lang.String)>/java.io.File.exists/0	<java.io.File: boolean exists()>
<at.bestsolution.util.BestsolutionConfiguration: void loadConfig(java.io.InputStream,java.lang.String)>/java.util.Properties.<init>/1	<java.util.Properties: void <init>(java.util.Properties)>
<at.bestsolution.util.BestsolutionConfiguration: void loadConfig(java.io.InputStream,java.lang.String)>/java.io.FileInputStream.<init>/0	<java.io.FileInputStream: void <init>(java.lang.String)>
<at.bestsolution.util.BestsolutionConfiguration: void loadConfig(java.io.InputStream,java.lang.String)>/java.util.Properties.load/1	<java.util.Properties: void load(java.io.InputStream)>
<at.bestsolution.util.BestsolutionConfiguration: void loadConfig(java.io.InputStream,java.lang.String)>/java.io.FileInputStream.close/0	<java.io.FileInputStream: void close()>
<at.bestsolution.util.BestsolutionConfiguration: void save()>/java.io.File.<init>/0	<java.io.File: void <init>(java.lang.String)>
<at.bestsolution.util.BestsolutionConfiguration: void save()>/java.io.File.exists/0	<java.io.File: boolean exists()>
<at.bestsolution.util.BestsolutionConfiguration: void save()>/java.io.File.getParentFile/0	<java.io.File: java.io.File getParentFile()>
<at.bestsolution.util.BestsolutionConfiguration: void save()>/java.io.File.getParentFile/1	<java.io.File: java.io.File getParentFile()>
<at.bestsolution.util.BestsolutionConfiguration: void save()>/java.io.File.createNewFile/0	<java.io.File: boolean createNewFile()>
<at.bestsolution.util.BestsolutionConfiguration: void save()>/java.io.FileOutputStream.<init>/0	<java.io.FileOutputStream: void <init>(java.io.File)>
<at.bestsolution.util.BestsolutionConfiguration: void save()>/java.util.Properties.store/0	<java.util.Properties: void store(java.io.OutputStream,java.lang.String)>
<at.bestsolution.util.BestsolutionConfiguration: void save()>/java.io.FileOutputStream.close/0	<java.io.FileOutputStream: void close()>
<at.bestsolution.util.BestsolutionConfiguration: void setProperty(java.lang.String,java.lang.String)>/java.util.Properties.setProperty/0	<java.util.Properties: java.lang.Object setProperty(java.lang.String,java.lang.String)>
<at.bestsolution.util.ExtensionsClassLoader$1: void <init>()>/java.lang.Object.<init>/0	<java.lang.Object: void <init>()>
<at.bestsolution.util.ExtensionsClassLoader: java.lang.Class class$(java.lang.String)>/java.lang.Class.forName/0	<java.lang.Class: java.lang.Class forName(java.lang.String)>
<at.bestsolution.util.ExtensionsClassLoader: java.lang.Class class$(java.lang.String)>/java.lang.NoClassDefFoundError.<init>/0	<java.lang.NoClassDefFoundError: void <init>()>
<at.bestsolution.util.ExtensionsClassLoader: java.lang.Class class$(java.lang.String)>/java.lang.NoClassDefFoundError.initCause/0	<java.lang.Throwable: java.lang.Throwable initCause(java.lang.Throwable)>
<at.bestsolution.util.ExtensionsClassLoader: java.lang.ClassLoader getClassLoader(java.lang.String)>/at.bestsolution.util.ExtensionsClassLoader.class$/0	<at.bestsolution.util.ExtensionsClassLoader: java.lang.Class class$(java.lang.String)>
<at.bestsolution.util.ExtensionsClassLoader: java.lang.ClassLoader getClassLoader(java.lang.String)>/java.util.ArrayList.<init>/0	<java.util.ArrayList: void <init>()>
<at.bestsolution.util.ExtensionsClassLoader: java.lang.ClassLoader getClassLoader(java.lang.String)>/java.io.File.<init>/0	<java.io.File: void <init>(java.lang.String)>
<at.bestsolution.util.ExtensionsClassLoader: java.lang.ClassLoader getClassLoader(java.lang.String)>/at.bestsolution.util.ExtensionsClassLoader$1.<init>/0	<at.bestsolution.util.ExtensionsClassLoader$1: void <init>()>
<at.bestsolution.util.ExtensionsClassLoader: java.lang.ClassLoader getClassLoader(java.lang.String)>/java.io.File.listFiles/0	<java.io.File: java.io.File[] listFiles(java.io.FileFilter)>
<at.bestsolution.util.ExtensionsClassLoader: java.lang.ClassLoader getClassLoader(java.lang.String)>/java.util.ArrayList.add/0	<java.util.ArrayList: boolean add(java.lang.Object)>
<at.bestsolution.util.ExtensionsClassLoader: java.lang.ClassLoader getClassLoader(java.lang.String)>/java.util.ArrayList.size/0	<java.util.ArrayList: int size()>
<at.bestsolution.util.ExtensionsClassLoader: java.lang.ClassLoader getClassLoader(java.lang.String)>/java.util.ArrayList.listIterator/0	<java.util.AbstractList: java.util.ListIterator listIterator()>
<at.bestsolution.util.ExtensionsClassLoader: java.lang.ClassLoader getClassLoader(java.lang.String)>/java.net.URLClassLoader.newInstance/0	<java.net.URLClassLoader: java.net.URLClassLoader newInstance(java.net.URL[])>
<at.bestsolution.util.ExtensionsClassLoader: java.lang.String getMainClassName(java.net.URL)>/java.lang.StringBuffer.<init>/0	<java.lang.StringBuffer: void <init>()>
<at.bestsolution.util.ExtensionsClassLoader: java.lang.String getMainClassName(java.net.URL)>/java.lang.StringBuffer.append/0	<java.lang.StringBuffer: java.lang.StringBuffer append(java.lang.Object)>
<at.bestsolution.util.ExtensionsClassLoader: java.lang.String getMainClassName(java.net.URL)>/java.net.URL.<init>/0	<java.net.URL: void <init>(java.lang.String,java.lang.String,java.lang.String)>
<at.bestsolution.util.ExtensionsClassLoader: java.lang.String getMainClassName(java.net.URL)>/java.net.URL.openConnection/0	<java.net.URL: java.net.URLConnection openConnection()>
<org.apache.batik.ext.awt.LinearGradientPaint: void <init>(java.awt.geom.Point2D,java.awt.geom.Point2D,float[],java.awt.Color[],org.apache.batik.ext.awt.MultipleGradientPaint$CycleMethodEnum,org.apache.batik.ext.awt.MultipleGradientPaint$ColorSpaceEnum)>/java.awt.geom.AffineTransform.<init>/0	<java.awt.geom.AffineTransform: void <init>()>
<org.apache.batik.ext.awt.LinearGradientPaint: void <init>(java.awt.geom.Point2D,java.awt.geom.Point2D,float[],java.awt.Color[],org.apache.batik.ext.awt.MultipleGradientPaint$CycleMethodEnum,org.apache.batik.ext.awt.MultipleGradientPaint$ColorSpaceEnum)>/org.apache.batik.ext.awt.LinearGradientPaint.<init>/0	<org.apache.batik.ext.awt.LinearGradientPaint: void <init>(java.awt.geom.Point2D,java.awt.geom.Point2D,float[],java.awt.Color[],org.apache.batik.ext.awt.MultipleGradientPaint$CycleMethodEnum,org.apache.batik.ext.awt.MultipleGradientPaint$ColorSpaceEnum,java.awt.geom.AffineTransform)>
<org.apache.batik.ext.awt.LinearGradientPaint: void <init>(java.awt.geom.Point2D,java.awt.geom.Point2D,float[],java.awt.Color[],org.apache.batik.ext.awt.MultipleGradientPaint$CycleMethodEnum,org.apache.batik.ext.awt.MultipleGradientPaint$ColorSpaceEnum,java.awt.geom.AffineTransform)>/org.apache.batik.ext.awt.MultipleGradientPaint.<init>/0	<org.apache.batik.ext.awt.MultipleGradientPaint: void <init>(float[],java.awt.Color[],org.apache.batik.ext.awt.MultipleGradientPaint$CycleMethodEnum,org.apache.batik.ext.awt.MultipleGradientPaint$ColorSpaceEnum,java.awt.geom.AffineTransform)>
<org.apache.batik.ext.awt.LinearGradientPaint: void <init>(java.awt.geom.Point2D,java.awt.geom.Point2D,float[],java.awt.Color[],org.apache.batik.ext.awt.MultipleGradientPaint$CycleMethodEnum,org.apache.batik.ext.awt.MultipleGradientPaint$ColorSpaceEnum,java.awt.geom.AffineTransform)>/java.lang.NullPointerException.<init>/0	<java.lang.NullPointerException: void <init>(java.lang.String)>
<org.apache.batik.ext.awt.LinearGradientPaint: void <init>(java.awt.geom.Point2D,java.awt.geom.Point2D,float[],java.awt.Color[],org.apache.batik.ext.awt.MultipleGradientPaint$CycleMethodEnum,org.apache.batik.ext.awt.MultipleGradientPaint$ColorSpaceEnum,java.awt.geom.AffineTransform)>/java.awt.geom.Point2D.equals/0	<java.awt.geom.Point2D: boolean equals(java.lang.Object)>
<org.apache.batik.ext.awt.LinearGradientPaint: void <init>(java.awt.geom.Point2D,java.awt.geom.Point2D,float[],java.awt.Color[],org.apache.batik.ext.awt.MultipleGradientPaint$CycleMethodEnum,org.apache.batik.ext.awt.MultipleGradientPaint$ColorSpaceEnum,java.awt.geom.AffineTransform)>/java.lang.IllegalArgumentException.<init>/0	<java.lang.IllegalArgumentException: void <init>(java.lang.String)>
<org.apache.batik.ext.awt.LinearGradientPaint: void <init>(java.awt.geom.Point2D,java.awt.geom.Point2D,float[],java.awt.Color[],org.apache.batik.ext.awt.MultipleGradientPaint$CycleMethodEnum,org.apache.batik.ext.awt.MultipleGradientPaint$ColorSpaceEnum,java.awt.geom.AffineTransform)>/java.awt.geom.Point2D.clone/0	<java.awt.geom.Point2D: java.lang.Object clone()>
<org.apache.batik.ext.awt.LinearGradientPaint: void <init>(java.awt.geom.Point2D,java.awt.geom.Point2D,float[],java.awt.Color[],org.apache.batik.ext.awt.MultipleGradientPaint$CycleMethodEnum,org.apache.batik.ext.awt.MultipleGradientPaint$ColorSpaceEnum,java.awt.geom.AffineTransform)>/java.awt.geom.Point2D.clone/1	<java.awt.geom.Point2D: java.lang.Object clone()>
<org.apache.batik.ext.awt.MultipleGradientPaint$ColorSpaceEnum: void <init>()>/java.lang.Object.<init>/0	<java.lang.Object: void <init>()>
<org.apache.batik.ext.awt.MultipleGradientPaint$CycleMethodEnum: void <init>()>/java.lang.Object.<init>/0	<java.lang.Object: void <init>()>
<org.apache.batik.ext.awt.MultipleGradientPaint: void <clinit>()>/org.apache.batik.ext.awt.MultipleGradientPaint$CycleMethodEnum.<init>/0	<org.apache.batik.ext.awt.MultipleGradientPaint$CycleMethodEnum: void <init>()>
<org.apache.batik.ext.awt.MultipleGradientPaint: void <clinit>()>/org.apache.batik.ext.awt.MultipleGradientPaint$CycleMethodEnum.<init>/1	<org.apache.batik.ext.awt.MultipleGradientPaint$CycleMethodEnum: void <init>()>
<org.apache.batik.ext.awt.MultipleGradientPaint: void <clinit>()>/org.apache.batik.ext.awt.MultipleGradientPaint$CycleMethodEnum.<init>/2	<org.apache.batik.ext.awt.MultipleGradientPaint$CycleMethodEnum: void <init>()>
<org.apache.batik.ext.awt.MultipleGradientPaint: void <clinit>()>/org.apache.batik.ext.awt.MultipleGradientPaint$ColorSpaceEnum.<init>/0	<org.apache.batik.ext.awt.MultipleGradientPaint$ColorSpaceEnum: void <init>()>
<org.apache.batik.ext.awt.MultipleGradientPaint: void <clinit>()>/org.apache.batik.ext.awt.MultipleGradientPaint$ColorSpaceEnum.<init>/1	<org.apache.batik.ext.awt.MultipleGradientPaint$ColorSpaceEnum: void <init>()>
<org.apache.batik.ext.awt.MultipleGradientPaint: void <init>(float[],java.awt.Color[],org.apache.batik.ext.awt.MultipleGradientPaint$CycleMethodEnum,org.apache.batik.ext.awt.MultipleGradientPaint$ColorSpaceEnum,java.awt.geom.AffineTransform)>/java.lang.Object.<init>/0	<java.lang.Object: void <init>()>
<org.apache.batik.ext.awt.MultipleGradientPaint: void <init>(float[],java.awt.Color[],org.apache.batik.ext.awt.MultipleGradientPaint$CycleMethodEnum,org.apache.batik.ext.awt.MultipleGradientPaint$ColorSpaceEnum,java.awt.geom.AffineTransform)>/java.lang.IllegalArgumentException.<init>/0	<java.lang.IllegalArgumentException: void <init>(java.lang.String)>
<org.apache.batik.ext.awt.MultipleGradientPaint: void <init>(float[],java.awt.Color[],org.apache.batik.ext.awt.MultipleGradientPaint$CycleMethodEnum,org.apache.batik.ext.awt.MultipleGradientPaint$ColorSpaceEnum,java.awt.geom.AffineTransform)>/java.lang.IllegalArgumentException.<init>/1	<java.lang.IllegalArgumentException: void <init>(java.lang.String)>
<org.apache.batik.ext.awt.MultipleGradientPaint: void <init>(float[],java.awt.Color[],org.apache.batik.ext.awt.MultipleGradientPaint$CycleMethodEnum,org.apache.batik.ext.awt.MultipleGradientPaint$ColorSpaceEnum,java.awt.geom.AffineTransform)>/java.lang.IllegalArgumentException.<init>/2	<java.lang.IllegalArgumentException: void <init>(java.lang.String)>
<org.apache.batik.ext.awt.MultipleGradientPaint: void <init>(float[],java.awt.Color[],org.apache.batik.ext.awt.MultipleGradientPaint$CycleMethodEnum,org.apache.batik.ext.awt.MultipleGradientPaint$ColorSpaceEnum,java.awt.geom.AffineTransform)>/java.lang.IllegalArgumentException.<init>/3	<java.lang.IllegalArgumentException: void <init>(java.lang.String)>
<org.apache.batik.ext.awt.MultipleGradientPaint: void <init>(float[],java.awt.Color[],org.apache.batik.ext.awt.MultipleGradientPaint$CycleMethodEnum,org.apache.batik.ext.awt.MultipleGradientPaint$ColorSpaceEnum,java.awt.geom.AffineTransform)>/java.lang.IllegalArgumentException.<init>/4	<java.lang.IllegalArgumentException: void <init>(java.lang.String)>
<org.apache.batik.ext.awt.MultipleGradientPaint: void <init>(float[],java.awt.Color[],org.apache.batik.ext.awt.MultipleGradientPaint$CycleMethodEnum,org.apache.batik.ext.awt.MultipleGradientPaint$ColorSpaceEnum,java.awt.geom.AffineTransform)>/java.lang.IllegalArgumentException.<init>/5	<java.lang.IllegalArgumentException: void <init>(java.lang.String)>
<org.apache.batik.ext.awt.MultipleGradientPaint: void <init>(float[],java.awt.Color[],org.apache.batik.ext.awt.MultipleGradientPaint$CycleMethodEnum,org.apache.batik.ext.awt.MultipleGradientPaint$ColorSpaceEnum,java.awt.geom.AffineTransform)>/java.lang.IllegalArgumentException.<init>/6	<java.lang.IllegalArgumentException: void <init>(java.lang.String)>
<org.apache.batik.ext.awt.MultipleGradientPaint: void <init>(float[],java.awt.Color[],org.apache.batik.ext.awt.MultipleGradientPaint$CycleMethodEnum,org.apache.batik.ext.awt.MultipleGradientPaint$ColorSpaceEnum,java.awt.geom.AffineTransform)>/java.lang.System.arraycopy/0	<java.lang.System: void arraycopy(java.lang.Object,int,java.lang.Object,int,int)>
<org.apache.batik.ext.awt.MultipleGradientPaint: void <init>(float[],java.awt.Color[],org.apache.batik.ext.awt.MultipleGradientPaint$CycleMethodEnum,org.apache.batik.ext.awt.MultipleGradientPaint$ColorSpaceEnum,java.awt.geom.AffineTransform)>/java.lang.System.arraycopy/1	<java.lang.System: void arraycopy(java.lang.Object,int,java.lang.Object,int,int)>
<org.apache.batik.ext.awt.MultipleGradientPaint: void <init>(float[],java.awt.Color[],org.apache.batik.ext.awt.MultipleGradientPaint$CycleMethodEnum,org.apache.batik.ext.awt.MultipleGradientPaint$ColorSpaceEnum,java.awt.geom.AffineTransform)>/java.awt.geom.AffineTransform.clone/0	<java.awt.geom.AffineTransform: java.lang.Object clone()>
