<org.jhotdraw.app.AbstractApplication$2: void <init>(org.jhotdraw.app.AbstractApplication)>/java.lang.Object.<init>/0	<java.lang.Object: void <init>()>
<org.jhotdraw.app.AbstractApplication: void <init>()>/org.jhotdraw.beans.AbstractBean.<init>/0	<org.jhotdraw.beans.AbstractBean: void <init>()>
<org.jhotdraw.app.AbstractApplication: void <init>()>/java.util.LinkedList.<init>/0	<java.util.LinkedList: void <init>()>
<org.jhotdraw.app.AbstractApplication: void <init>()>/java.util.LinkedList.<init>/1	<java.util.LinkedList: void <init>()>
<org.jhotdraw.app.AbstractApplication: void launch(java.lang.String[])>/org.jhotdraw.app.AbstractApplication.configure/0	<org.jhotdraw.app.OSXApplication: void configure(java.lang.String[])>
<org.jhotdraw.app.AbstractApplication: void launch(java.lang.String[])>/org.jhotdraw.app.AbstractApplication.configure/0	<org.jhotdraw.app.SDIApplication: void configure(java.lang.String[])>
<org.jhotdraw.app.AbstractApplication: void launch(java.lang.String[])>/org.jhotdraw.app.AbstractApplication$2.<init>/0	<org.jhotdraw.app.AbstractApplication$2: void <init>(org.jhotdraw.app.AbstractApplication)>
<org.jhotdraw.app.AbstractApplication: void launch(java.lang.String[])>/javax.swing.SwingUtilities.invokeLater/0	<javax.swing.SwingUtilities: void invokeLater(java.lang.Runnable)>
<org.jhotdraw.app.AbstractApplication: void setModel(org.jhotdraw.app.ApplicationModel)>/org.jhotdraw.app.AbstractApplication.firePropertyChange/0	<org.jhotdraw.beans.AbstractBean: void firePropertyChange(java.lang.String,java.lang.Object,java.lang.Object)>
<org.jhotdraw.app.AbstractApplicationModel: void <init>()>/org.jhotdraw.beans.AbstractBean.<init>/0	<org.jhotdraw.beans.AbstractBean: void <init>()>
<org.jhotdraw.app.AbstractApplicationModel: void setCopyright(java.lang.String)>/org.jhotdraw.app.AbstractApplicationModel.firePropertyChange/0	<org.jhotdraw.beans.AbstractBean: void firePropertyChange(java.lang.String,java.lang.Object,java.lang.Object)>
<org.jhotdraw.app.AbstractApplicationModel: void setName(java.lang.String)>/org.jhotdraw.app.AbstractApplicationModel.firePropertyChange/0	<org.jhotdraw.beans.AbstractBean: void firePropertyChange(java.lang.String,java.lang.Object,java.lang.Object)>
<org.jhotdraw.app.AbstractApplicationModel: void setVersion(java.lang.String)>/org.jhotdraw.app.AbstractApplicationModel.firePropertyChange/0	<org.jhotdraw.beans.AbstractBean: void firePropertyChange(java.lang.String,java.lang.Object,java.lang.Object)>
<org.jhotdraw.app.AbstractApplicationModel: void setViewClassName(java.lang.String)>/org.jhotdraw.app.AbstractApplicationModel.firePropertyChange/0	<org.jhotdraw.beans.AbstractBean: void firePropertyChange(java.lang.String,java.lang.Object,java.lang.Object)>
<org.jhotdraw.app.DefaultApplicationModel: void <init>()>/org.jhotdraw.app.AbstractApplicationModel.<init>/0	<org.jhotdraw.app.AbstractApplicationModel: void <init>()>
<org.jhotdraw.app.OSXApplication: void <init>()>/org.jhotdraw.app.AbstractApplication.<init>/0	<org.jhotdraw.app.AbstractApplication: void <init>()>
<org.jhotdraw.app.OSXApplication: void configure(java.lang.String[])>/java.lang.System.setProperty/0	<java.lang.System: java.lang.String setProperty(java.lang.String,java.lang.String)>
<org.jhotdraw.app.OSXApplication: void configure(java.lang.String[])>/java.lang.System.setProperty/1	<java.lang.System: java.lang.String setProperty(java.lang.String,java.lang.String)>
<org.jhotdraw.app.OSXApplication: void launch(java.lang.String[])>/java.lang.System.setProperty/0	<java.lang.System: java.lang.String setProperty(java.lang.String,java.lang.String)>
<org.jhotdraw.app.OSXApplication: void launch(java.lang.String[])>/org.jhotdraw.app.AbstractApplication.launch/0	<org.jhotdraw.app.AbstractApplication: void launch(java.lang.String[])>
<org.jhotdraw.app.SDIApplication: void <init>()>/org.jhotdraw.app.AbstractApplication.<init>/0	<org.jhotdraw.app.AbstractApplication: void <init>()>
<org.jhotdraw.app.SDIApplication: void configure(java.lang.String[])>/java.lang.System.setProperty/0	<java.lang.System: java.lang.String setProperty(java.lang.String,java.lang.String)>
<org.jhotdraw.app.SDIApplication: void configure(java.lang.String[])>/java.lang.System.setProperty/1	<java.lang.System: java.lang.String setProperty(java.lang.String,java.lang.String)>
<org.jhotdraw.app.SDIApplication: void configure(java.lang.String[])>/java.lang.System.setProperty/2	<java.lang.System: java.lang.String setProperty(java.lang.String,java.lang.String)>
<org.jhotdraw.app.SDIApplication: void configure(java.lang.String[])>/java.lang.System.setProperty/3	<java.lang.System: java.lang.String setProperty(java.lang.String,java.lang.String)>
<org.jhotdraw.app.SDIApplication: void launch(java.lang.String[])>/java.lang.System.setProperty/0	<java.lang.System: java.lang.String setProperty(java.lang.String,java.lang.String)>
<org.jhotdraw.app.SDIApplication: void launch(java.lang.String[])>/org.jhotdraw.app.AbstractApplication.launch/0	<org.jhotdraw.app.AbstractApplication: void launch(java.lang.String[])>
<org.jhotdraw.beans.AbstractBean: void <init>()>/java.lang.Object.<init>/0	<java.lang.Object: void <init>()>
<org.jhotdraw.beans.AbstractBean: void <init>()>/java.beans.PropertyChangeSupport.<init>/0	<java.beans.PropertyChangeSupport: void <init>(java.lang.Object)>
<org.jhotdraw.beans.AbstractBean: void firePropertyChange(java.lang.String,java.lang.Object,java.lang.Object)>/java.beans.PropertyChangeSupport.firePropertyChange/0	<java.beans.PropertyChangeSupport: void firePropertyChange(java.lang.String,java.lang.Object,java.lang.Object)>
<org.jhotdraw.samples.draw.DrawApplicationModel: void <init>()>/org.jhotdraw.app.DefaultApplicationModel.<init>/0	<org.jhotdraw.app.DefaultApplicationModel: void <init>()>
<org.jhotdraw.samples.draw.Main: void main(java.lang.String[])>/org.jhotdraw.util.ResourceBundleUtil.setVerbose/0	<org.jhotdraw.util.ResourceBundleUtil: void setVerbose(boolean)>
<org.jhotdraw.samples.draw.Main: void main(java.lang.String[])>/java.lang.System.getProperty/0	<java.lang.System: java.lang.String getProperty(java.lang.String)>
<org.jhotdraw.samples.draw.Main: void main(java.lang.String[])>/org.jhotdraw.app.OSXApplication.<init>/0	<org.jhotdraw.app.OSXApplication: void <init>()>
<org.jhotdraw.samples.draw.Main: void main(java.lang.String[])>/org.jhotdraw.app.SDIApplication.<init>/0	<org.jhotdraw.app.SDIApplication: void <init>()>
<org.jhotdraw.samples.draw.Main: void main(java.lang.String[])>/org.jhotdraw.app.SDIApplication.<init>/1	<org.jhotdraw.app.SDIApplication: void <init>()>
<org.jhotdraw.samples.draw.Main: void main(java.lang.String[])>/org.jhotdraw.samples.draw.DrawApplicationModel.<init>/0	<org.jhotdraw.samples.draw.DrawApplicationModel: void <init>()>
<org.jhotdraw.samples.draw.Main: void main(java.lang.String[])>/org.jhotdraw.samples.draw.DrawApplicationModel.setName/0	<org.jhotdraw.app.AbstractApplicationModel: void setName(java.lang.String)>
<org.jhotdraw.samples.draw.Main: void main(java.lang.String[])>/java.lang.Class.getPackage/0	<java.lang.Class: java.lang.Package getPackage()>
<org.jhotdraw.samples.draw.Main: void main(java.lang.String[])>/org.jhotdraw.samples.draw.DrawApplicationModel.setVersion/0	<org.jhotdraw.app.AbstractApplicationModel: void setVersion(java.lang.String)>
<org.jhotdraw.samples.draw.Main: void main(java.lang.String[])>/org.jhotdraw.samples.draw.DrawApplicationModel.setCopyright/0	<org.jhotdraw.app.AbstractApplicationModel: void setCopyright(java.lang.String)>
<org.jhotdraw.samples.draw.Main: void main(java.lang.String[])>/org.jhotdraw.samples.draw.DrawApplicationModel.setViewClassName/0	<org.jhotdraw.app.AbstractApplicationModel: void setViewClassName(java.lang.String)>
<org.jhotdraw.samples.draw.Main: void main(java.lang.String[])>/org.jhotdraw.app.Application.setModel/0	<org.jhotdraw.app.AbstractApplication: void setModel(org.jhotdraw.app.ApplicationModel)>
<org.jhotdraw.samples.draw.Main: void main(java.lang.String[])>/org.jhotdraw.app.Application.launch/0	<org.jhotdraw.app.OSXApplication: void launch(java.lang.String[])>
<org.jhotdraw.samples.draw.Main: void main(java.lang.String[])>/org.jhotdraw.app.Application.launch/0	<org.jhotdraw.app.SDIApplication: void launch(java.lang.String[])>
<org.jhotdraw.util.ResourceBundleUtil: void <clinit>()>/java.util.Arrays.asList/0	<java.util.Arrays: java.util.List asList(java.lang.Object[])>
<org.jhotdraw.util.ResourceBundleUtil: void <clinit>()>/java.util.HashSet.<init>/0	<java.util.HashSet: void <init>(java.util.Collection)>
<org.jhotdraw.util.ResourceBundleUtil: void <clinit>()>/java.util.HashMap.<init>/0	<java.util.HashMap: void <init>()>
<org.jhotdraw.util.ResourceBundleUtil: void <clinit>()>/java.lang.System.getProperty/0	<java.lang.System: java.lang.String getProperty(java.lang.String)>
<org.jhotdraw.util.ResourceBundleUtil: void <clinit>()>/java.util.HashMap.put/0	<java.util.HashMap: java.lang.Object put(java.lang.Object,java.lang.Object)>
