<org.apache.xalan.processor.XSLProcessorVersion: void <clinit>()>/java.lang.StringBuffer.<init>/0	<java.lang.StringBuffer: void <init>(java.lang.String)>
<org.apache.xalan.processor.XSLProcessorVersion: void <clinit>()>/java.lang.StringBuffer.append/0	<java.lang.StringBuffer: java.lang.StringBuffer append(java.lang.String)>
<org.apache.xalan.processor.XSLProcessorVersion: void <clinit>()>/java.lang.StringBuffer.<init>/1	<java.lang.StringBuffer: void <init>(java.lang.String)>
<org.apache.xalan.processor.XSLProcessorVersion: void <clinit>()>/java.lang.StringBuffer.append/6	<java.lang.StringBuffer: java.lang.StringBuffer append(int)>
<org.apache.xalan.processor.XSLProcessorVersion: void <clinit>()>/java.lang.String.valueOf/0	<java.lang.String: java.lang.String valueOf(int)>
<org.apache.xalan.res.XSLMessages: java.lang.String createMessage(int,java.lang.Object[])>/org.apache.xalan.res.XSLMessages.loadResourceBundle/0	<org.apache.xalan.res.XSLMessages: java.util.ListResourceBundle loadResourceBundle(java.lang.String)>
<org.apache.xalan.res.XSLMessages: java.lang.String createMessage(int,java.lang.Object[])>/org.apache.xalan.res.XSLMessages.createMsg/0	<org.apache.xalan.res.XSLMessages: java.lang.String createMsg(org.apache.xml.utils.res.XResourceBundleBase,java.lang.String,java.lang.Object[])>
<org.apache.xalan.res.XSLMessages: java.lang.String createMsg(org.apache.xml.utils.res.XResourceBundleBase,java.lang.String,java.lang.Object[])>/java.text.MessageFormat.format/0	<java.text.MessageFormat: java.lang.String format(java.lang.String,java.lang.Object[])>
<org.apache.xalan.res.XSLMessages: java.lang.String createMsg(org.apache.xml.utils.res.XResourceBundleBase,java.lang.String,java.lang.Object[])>/java.lang.String.valueOf/0	<java.lang.String: java.lang.String valueOf(java.lang.Object)>
<org.apache.xalan.res.XSLMessages: java.lang.String createMsg(org.apache.xml.utils.res.XResourceBundleBase,java.lang.String,java.lang.Object[])>/java.lang.StringBuffer.<init>/0	<java.lang.StringBuffer: void <init>(java.lang.String)>
<org.apache.xalan.res.XSLMessages: java.lang.String createMsg(org.apache.xml.utils.res.XResourceBundleBase,java.lang.String,java.lang.Object[])>/java.lang.StringBuffer.append/0	<java.lang.StringBuffer: java.lang.StringBuffer append(java.lang.String)>
<org.apache.xalan.res.XSLMessages: java.lang.String createMsg(org.apache.xml.utils.res.XResourceBundleBase,java.lang.String,java.lang.Object[])>/java.lang.RuntimeException.<init>/0	<java.lang.RuntimeException: void <init>(java.lang.String)>
<org.apache.xalan.res.XSLMessages: java.util.ListResourceBundle loadResourceBundle(java.lang.String)>/java.util.Locale.getDefault/0	<java.util.Locale: java.util.Locale getDefault()>
<org.apache.xalan.res.XSLMessages: java.util.ListResourceBundle loadResourceBundle(java.lang.String)>/java.util.ResourceBundle.getBundle/0	<java.util.ResourceBundle: java.util.ResourceBundle getBundle(java.lang.String,java.util.Locale)>
<org.apache.xalan.res.XSLMessages: java.util.ListResourceBundle loadResourceBundle(java.lang.String)>/java.util.Locale.<init>/0	<java.util.Locale: void <init>(java.lang.String,java.lang.String)>
<org.apache.xalan.res.XSLMessages: java.util.ListResourceBundle loadResourceBundle(java.lang.String)>/java.util.ResourceBundle.getBundle/1	<java.util.ResourceBundle: java.util.ResourceBundle getBundle(java.lang.String,java.util.Locale)>
<org.apache.xalan.res.XSLMessages: java.util.ListResourceBundle loadResourceBundle(java.lang.String)>/java.lang.StringBuffer.<init>/0	<java.lang.StringBuffer: void <init>(java.lang.String)>
<org.apache.xalan.res.XSLMessages: java.util.ListResourceBundle loadResourceBundle(java.lang.String)>/java.lang.StringBuffer.append/0	<java.lang.StringBuffer: java.lang.StringBuffer append(java.lang.String)>
<org.apache.xalan.res.XSLMessages: java.util.ListResourceBundle loadResourceBundle(java.lang.String)>/java.util.MissingResourceException.<init>/0	<java.util.MissingResourceException: void <init>(java.lang.String,java.lang.String,java.lang.String)>
<org.apache.xalan.trace.PrintTraceListener: void <init>(java.io.PrintWriter)>/java.lang.Object.<init>/0	<java.lang.Object: void <init>()>
<org.apache.xalan.xslt.Process: void doExit(int)>/java.lang.System.exit/0	<java.lang.System: void exit(int)>
<org.apache.xalan.xslt.Process: void main(java.lang.String[])>/java.io.PrintWriter.<init>/0	<java.io.PrintWriter: void <init>(java.io.OutputStream,boolean)>
<org.apache.xalan.xslt.Process: void main(java.lang.String[])>/org.apache.xalan.res.XSLMessages.loadResourceBundle/0	<org.apache.xalan.res.XSLMessages: java.util.ListResourceBundle loadResourceBundle(java.lang.String)>
<org.apache.xalan.xslt.Process: void main(java.lang.String[])>/org.apache.xalan.xslt.Process.printArgOptions/0	<org.apache.xalan.xslt.Process: void printArgOptions(org.apache.xalan.res.XSLTErrorResources)>
<org.apache.xalan.xslt.Process: void main(java.lang.String[])>/javax.xml.transform.TransformerFactory.newInstance/0	<javax.xml.transform.TransformerFactory: javax.xml.transform.TransformerFactory newInstance()>
<org.apache.xalan.xslt.Process: void main(java.lang.String[])>/org.apache.xalan.res.XSLMessages.createMessage/0	<org.apache.xalan.res.XSLMessages: java.lang.String createMessage(int,java.lang.Object[])>
<org.apache.xalan.xslt.Process: void main(java.lang.String[])>/java.io.PrintWriter.println/0	<java.io.PrintWriter: void println(java.lang.String)>
<org.apache.xalan.xslt.Process: void main(java.lang.String[])>/org.apache.xalan.xslt.Process.doExit/0	<org.apache.xalan.xslt.Process: void doExit(int)>
<org.apache.xalan.xslt.Process: void main(java.lang.String[])>/java.util.Vector.<init>/0	<java.util.Vector: void <init>()>
<org.apache.xalan.xslt.Process: void main(java.lang.String[])>/java.lang.String.equalsIgnoreCase/0	<java.lang.String: boolean equalsIgnoreCase(java.lang.String)>
<org.apache.xalan.xslt.Process: void main(java.lang.String[])>/org.apache.xalan.trace.PrintTraceListener.<init>/0	<org.apache.xalan.trace.PrintTraceListener: void <init>(java.io.PrintWriter)>
<org.apache.xalan.xslt.Process: void main(java.lang.String[])>/java.lang.String.equalsIgnoreCase/1	<java.lang.String: boolean equalsIgnoreCase(java.lang.String)>
<org.apache.xalan.xslt.Process: void main(java.lang.String[])>/org.apache.xalan.trace.PrintTraceListener.<init>/1	<org.apache.xalan.trace.PrintTraceListener: void <init>(java.io.PrintWriter)>
<org.apache.xalan.xslt.Process: void main(java.lang.String[])>/java.lang.String.equalsIgnoreCase/2	<java.lang.String: boolean equalsIgnoreCase(java.lang.String)>
<org.apache.xalan.xslt.Process: void main(java.lang.String[])>/org.apache.xalan.trace.PrintTraceListener.<init>/2	<org.apache.xalan.trace.PrintTraceListener: void <init>(java.io.PrintWriter)>
<org.apache.xalan.xslt.Process: void main(java.lang.String[])>/java.lang.String.equalsIgnoreCase/3	<java.lang.String: boolean equalsIgnoreCase(java.lang.String)>
<org.apache.xalan.xslt.Process: void main(java.lang.String[])>/org.apache.xalan.trace.PrintTraceListener.<init>/3	<org.apache.xalan.trace.PrintTraceListener: void <init>(java.io.PrintWriter)>
<org.apache.xalan.xslt.Process: void main(java.lang.String[])>/java.lang.String.equalsIgnoreCase/4	<java.lang.String: boolean equalsIgnoreCase(java.lang.String)>
<org.apache.xalan.xslt.Process: void main(java.lang.String[])>/java.lang.String.charAt/0	<java.lang.String: char charAt(int)>
<org.apache.xalan.xslt.Process: void main(java.lang.String[])>/java.lang.Integer.parseInt/0	<java.lang.Integer: int parseInt(java.lang.String)>
<org.apache.xalan.xslt.Process: void main(java.lang.String[])>/java.lang.String.equalsIgnoreCase/5	<java.lang.String: boolean equalsIgnoreCase(java.lang.String)>
<org.apache.xalan.xslt.Process: void main(java.lang.String[])>/org.apache.xalan.res.XSLMessages.createMessage/1	<org.apache.xalan.res.XSLMessages: java.lang.String createMessage(int,java.lang.Object[])>
<org.apache.xalan.xslt.Process: void main(java.lang.String[])>/java.lang.String.equalsIgnoreCase/6	<java.lang.String: boolean equalsIgnoreCase(java.lang.String)>
<org.apache.xalan.xslt.Process: void main(java.lang.String[])>/org.apache.xalan.res.XSLMessages.createMessage/2	<org.apache.xalan.res.XSLMessages: java.lang.String createMessage(int,java.lang.Object[])>
<org.apache.xalan.xslt.Process: void main(java.lang.String[])>/java.lang.String.equalsIgnoreCase/7	<java.lang.String: boolean equalsIgnoreCase(java.lang.String)>
<org.apache.xalan.xslt.Process: void main(java.lang.String[])>/org.apache.xalan.res.XSLMessages.createMessage/3	<org.apache.xalan.res.XSLMessages: java.lang.String createMessage(int,java.lang.Object[])>
<org.apache.xalan.xslt.Process: void main(java.lang.String[])>/java.lang.String.equalsIgnoreCase/8	<java.lang.String: boolean equalsIgnoreCase(java.lang.String)>
<org.apache.xalan.xslt.Process: void main(java.lang.String[])>/org.apache.xalan.res.XSLMessages.createMessage/4	<org.apache.xalan.res.XSLMessages: java.lang.String createMessage(int,java.lang.Object[])>
<org.apache.xalan.xslt.Process: void main(java.lang.String[])>/java.lang.String.equalsIgnoreCase/9	<java.lang.String: boolean equalsIgnoreCase(java.lang.String)>
<org.apache.xalan.xslt.Process: void main(java.lang.String[])>/org.apache.xalan.res.XSLMessages.createMessage/5	<org.apache.xalan.res.XSLMessages: java.lang.String createMessage(int,java.lang.Object[])>
<org.apache.xalan.xslt.Process: void main(java.lang.String[])>/java.lang.String.equalsIgnoreCase/10	<java.lang.String: boolean equalsIgnoreCase(java.lang.String)>
<org.apache.xalan.xslt.Process: void main(java.lang.String[])>/java.util.Vector.addElement/0	<java.util.Vector: void addElement(java.lang.Object)>
<org.apache.xalan.xslt.Process: void main(java.lang.String[])>/java.util.Vector.addElement/1	<java.util.Vector: void addElement(java.lang.Object)>
<org.apache.xalan.xslt.Process: void main(java.lang.String[])>/org.apache.xalan.res.XSLMessages.createMessage/6	<org.apache.xalan.res.XSLMessages: java.lang.String createMessage(int,java.lang.Object[])>
<org.apache.xalan.xslt.Process: void main(java.lang.String[])>/java.lang.String.equalsIgnoreCase/11	<java.lang.String: boolean equalsIgnoreCase(java.lang.String)>
<org.apache.xalan.xslt.Process: void main(java.lang.String[])>/org.apache.xalan.res.XSLMessages.createMessage/7	<org.apache.xalan.res.XSLMessages: java.lang.String createMessage(int,java.lang.Object[])>
<org.apache.xalan.xslt.Process: void main(java.lang.String[])>/java.lang.String.equalsIgnoreCase/12	<java.lang.String: boolean equalsIgnoreCase(java.lang.String)>
<org.apache.xalan.xslt.Process: void main(java.lang.String[])>/java.lang.String.equalsIgnoreCase/13	<java.lang.String: boolean equalsIgnoreCase(java.lang.String)>
<org.apache.xalan.xslt.Process: void main(java.lang.String[])>/java.lang.String.equalsIgnoreCase/14	<java.lang.String: boolean equalsIgnoreCase(java.lang.String)>
<org.apache.xalan.xslt.Process: void main(java.lang.String[])>/java.lang.String.valueOf/0	<java.lang.String: java.lang.String valueOf(java.lang.Object)>
<org.apache.xalan.xslt.Process: void main(java.lang.String[])>/java.lang.StringBuffer.<init>/0	<java.lang.StringBuffer: void <init>(java.lang.String)>
<org.apache.xalan.xslt.Process: void main(java.lang.String[])>/java.lang.StringBuffer.append/0	<java.lang.StringBuffer: java.lang.StringBuffer append(java.lang.String)>
<org.apache.xalan.xslt.Process: void main(java.lang.String[])>/java.io.PrintWriter.println/1	<java.io.PrintWriter: void println(java.lang.String)>
<org.apache.xalan.xslt.Process: void main(java.lang.String[])>/java.lang.String.equalsIgnoreCase/15	<java.lang.String: boolean equalsIgnoreCase(java.lang.String)>
<org.apache.xalan.xslt.Process: void main(java.lang.String[])>/java.lang.String.equalsIgnoreCase/16	<java.lang.String: boolean equalsIgnoreCase(java.lang.String)>
<org.apache.xalan.xslt.Process: void main(java.lang.String[])>/java.lang.String.equalsIgnoreCase/17	<java.lang.String: boolean equalsIgnoreCase(java.lang.String)>
<org.apache.xalan.xslt.Process: void main(java.lang.String[])>/java.lang.String.equalsIgnoreCase/18	<java.lang.String: boolean equalsIgnoreCase(java.lang.String)>
<org.apache.xalan.xslt.Process: void main(java.lang.String[])>/java.lang.String.equalsIgnoreCase/19	<java.lang.String: boolean equalsIgnoreCase(java.lang.String)>
<org.apache.xalan.xslt.Process: void main(java.lang.String[])>/java.lang.String.equalsIgnoreCase/20	<java.lang.String: boolean equalsIgnoreCase(java.lang.String)>
<org.apache.xalan.xslt.Process: void main(java.lang.String[])>/java.lang.String.equalsIgnoreCase/21	<java.lang.String: boolean equalsIgnoreCase(java.lang.String)>
<org.apache.xalan.xslt.Process: void main(java.lang.String[])>/java.lang.String.charAt/1	<java.lang.String: char charAt(int)>
<org.apache.xalan.xslt.Process: void main(java.lang.String[])>/java.lang.String.equalsIgnoreCase/22	<java.lang.String: boolean equalsIgnoreCase(java.lang.String)>
<org.apache.xalan.xslt.Process: void main(java.lang.String[])>/java.lang.Class.forName/0	<java.lang.Class: java.lang.Class forName(java.lang.String)>
<org.apache.xalan.xslt.Process: void main(java.lang.String[])>/org.apache.xalan.res.XSLMessages.createMessage/8	<org.apache.xalan.res.XSLMessages: java.lang.String createMessage(int,java.lang.Object[])>
<org.apache.xalan.xslt.Process: void main(java.lang.String[])>/org.apache.xalan.xslt.Process.doExit/1	<org.apache.xalan.xslt.Process: void doExit(int)>
<org.apache.xalan.xslt.Process: void main(java.lang.String[])>/org.apache.xalan.res.XSLMessages.createMessage/9	<org.apache.xalan.res.XSLMessages: java.lang.String createMessage(int,java.lang.Object[])>
<org.apache.xalan.xslt.Process: void main(java.lang.String[])>/org.apache.xalan.xslt.Process.doExit/2	<org.apache.xalan.xslt.Process: void doExit(int)>
<org.apache.xalan.xslt.Process: void main(java.lang.String[])>/java.lang.String.equalsIgnoreCase/23	<java.lang.String: boolean equalsIgnoreCase(java.lang.String)>
<org.apache.xalan.xslt.Process: void main(java.lang.String[])>/java.lang.Class.forName/1	<java.lang.Class: java.lang.Class forName(java.lang.String)>
<org.apache.xalan.xslt.Process: void main(java.lang.String[])>/org.apache.xalan.res.XSLMessages.createMessage/10	<org.apache.xalan.res.XSLMessages: java.lang.String createMessage(int,java.lang.Object[])>
<org.apache.xalan.xslt.Process: void main(java.lang.String[])>/org.apache.xalan.xslt.Process.doExit/3	<org.apache.xalan.xslt.Process: void doExit(int)>
<org.apache.xalan.xslt.Process: void main(java.lang.String[])>/org.apache.xalan.res.XSLMessages.createMessage/11	<org.apache.xalan.res.XSLMessages: java.lang.String createMessage(int,java.lang.Object[])>
<org.apache.xalan.xslt.Process: void main(java.lang.String[])>/org.apache.xalan.xslt.Process.doExit/4	<org.apache.xalan.xslt.Process: void doExit(int)>
<org.apache.xalan.xslt.Process: void main(java.lang.String[])>/java.lang.String.equalsIgnoreCase/24	<java.lang.String: boolean equalsIgnoreCase(java.lang.String)>
<org.apache.xalan.xslt.Process: void main(java.lang.String[])>/java.lang.Class.forName/2	<java.lang.Class: java.lang.Class forName(java.lang.String)>
<org.apache.xalan.xslt.Process: void main(java.lang.String[])>/org.apache.xalan.res.XSLMessages.createMessage/12	<org.apache.xalan.res.XSLMessages: java.lang.String createMessage(int,java.lang.Object[])>
<org.apache.xalan.xslt.Process: void main(java.lang.String[])>/org.apache.xalan.xslt.Process.doExit/5	<org.apache.xalan.xslt.Process: void doExit(int)>
<org.apache.xalan.xslt.Process: void main(java.lang.String[])>/org.apache.xalan.res.XSLMessages.createMessage/13	<org.apache.xalan.res.XSLMessages: java.lang.String createMessage(int,java.lang.Object[])>
<org.apache.xalan.xslt.Process: void main(java.lang.String[])>/org.apache.xalan.xslt.Process.doExit/6	<org.apache.xalan.xslt.Process: void doExit(int)>
<org.apache.xalan.xslt.Process: void main(java.lang.String[])>/java.lang.String.equalsIgnoreCase/25	<java.lang.String: boolean equalsIgnoreCase(java.lang.String)>
<org.apache.xalan.xslt.Process: void main(java.lang.String[])>/org.apache.xalan.res.XSLMessages.createMessage/14	<org.apache.xalan.res.XSLMessages: java.lang.String createMessage(int,java.lang.Object[])>
<org.apache.xalan.xslt.Process: void main(java.lang.String[])>/java.lang.System.currentTimeMillis/0	<java.lang.System: long currentTimeMillis()>
<org.apache.xalan.xslt.Process: void main(java.lang.String[])>/java.io.FileWriter.<init>/0	<java.io.FileWriter: void <init>(java.lang.String)>
<org.apache.xalan.xslt.Process: void main(java.lang.String[])>/java.io.PrintWriter.<init>/1	<java.io.PrintWriter: void <init>(java.io.Writer)>
<org.apache.xalan.xslt.Process: void main(java.lang.String[])>/java.lang.String.equals/0	<java.lang.String: boolean equals(java.lang.Object)>
<org.apache.xalan.xslt.Process: void main(java.lang.String[])>/javax.xml.parsers.DocumentBuilderFactory.newInstance/0	<javax.xml.parsers.DocumentBuilderFactory: javax.xml.parsers.DocumentBuilderFactory newInstance()>
<org.apache.xalan.xslt.Process: void main(java.lang.String[])>/org.xml.sax.InputSource.<init>/0	<org.xml.sax.InputSource: void <init>(java.lang.String)>
<org.apache.xalan.xslt.Process: void main(java.lang.String[])>/javax.xml.transform.dom.DOMSource.<init>/0	<javax.xml.transform.dom.DOMSource: void <init>(org.w3c.dom.Node,java.lang.String)>
<org.apache.xalan.xslt.Process: void main(java.lang.String[])>/javax.xml.transform.stream.StreamSource.<init>/0	<javax.xml.transform.stream.StreamSource: void <init>(java.lang.String)>
<org.apache.xalan.xslt.Process: void main(java.lang.String[])>/java.io.FileOutputStream.<init>/0	<java.io.FileOutputStream: void <init>(java.lang.String)>
<org.apache.xalan.xslt.Process: void main(java.lang.String[])>/javax.xml.transform.stream.StreamResult.<init>/0	<javax.xml.transform.stream.StreamResult: void <init>(java.io.OutputStream)>
<org.apache.xalan.xslt.Process: void main(java.lang.String[])>/javax.xml.transform.stream.StreamResult.<init>/1	<javax.xml.transform.stream.StreamResult: void <init>(java.io.OutputStream)>
<org.apache.xalan.xslt.Process: void main(java.lang.String[])>/javax.xml.transform.stream.StreamSource.<init>/1	<javax.xml.transform.stream.StreamSource: void <init>(java.lang.String)>
<org.apache.xalan.xslt.Process: void main(java.lang.String[])>/org.apache.xalan.res.XSLMessages.createMessage/15	<org.apache.xalan.res.XSLMessages: java.lang.String createMessage(int,java.lang.Object[])>
<org.apache.xalan.xslt.Process: void main(java.lang.String[])>/javax.xml.transform.TransformerException.<init>/0	<javax.xml.transform.TransformerException: void <init>(java.lang.String)>
<org.apache.xalan.xslt.Process: void main(java.lang.String[])>/org.apache.xalan.res.XSLMessages.createMessage/16	<org.apache.xalan.res.XSLMessages: java.lang.String createMessage(int,java.lang.Object[])>
<org.apache.xalan.xslt.Process: void main(java.lang.String[])>/javax.xml.transform.TransformerException.<init>/1	<javax.xml.transform.TransformerException: void <init>(java.lang.String)>
<org.apache.xalan.xslt.Process: void main(java.lang.String[])>/java.lang.String.equals/1	<java.lang.String: boolean equals(java.lang.Object)>
<org.apache.xalan.xslt.Process: void main(java.lang.String[])>/java.util.Vector.size/0	<java.util.Vector: int size()>
<org.apache.xalan.xslt.Process: void main(java.lang.String[])>/java.util.Vector.elementAt/0	<java.util.Vector: java.lang.Object elementAt(int)>
<org.apache.xalan.xslt.Process: void main(java.lang.String[])>/java.util.Vector.elementAt/1	<java.util.Vector: java.lang.Object elementAt(int)>
<org.apache.xalan.xslt.Process: void main(java.lang.String[])>/java.lang.String.equals/2	<java.lang.String: boolean equals(java.lang.Object)>
<org.apache.xalan.xslt.Process: void main(java.lang.String[])>/javax.xml.parsers.DocumentBuilderFactory.newInstance/1	<javax.xml.parsers.DocumentBuilderFactory: javax.xml.parsers.DocumentBuilderFactory newInstance()>
<org.apache.xalan.xslt.Process: void main(java.lang.String[])>/org.xml.sax.InputSource.<init>/1	<org.xml.sax.InputSource: void <init>(java.lang.String)>
<org.apache.xalan.xslt.Process: void main(java.lang.String[])>/javax.xml.transform.dom.DOMSource.<init>/1	<javax.xml.transform.dom.DOMSource: void <init>(org.w3c.dom.Node,java.lang.String)>
<org.apache.xalan.xslt.Process: void main(java.lang.String[])>/javax.xml.transform.dom.DOMResult.<init>/0	<javax.xml.transform.dom.DOMResult: void <init>(org.w3c.dom.Node)>
<org.apache.xalan.xslt.Process: void main(java.lang.String[])>/javax.xml.transform.sax.SAXResult.<init>/0	<javax.xml.transform.sax.SAXResult: void <init>(org.xml.sax.ContentHandler)>
<org.apache.xalan.xslt.Process: void main(java.lang.String[])>/javax.xml.transform.dom.DOMSource.<init>/2	<javax.xml.transform.dom.DOMSource: void <init>(org.w3c.dom.Node)>
<org.apache.xalan.xslt.Process: void main(java.lang.String[])>/javax.xml.transform.dom.DOMSource.<init>/3	<javax.xml.transform.dom.DOMSource: void <init>(org.w3c.dom.Node)>
<org.apache.xalan.xslt.Process: void main(java.lang.String[])>/java.lang.String.equals/3	<java.lang.String: boolean equals(java.lang.Object)>
<org.apache.xalan.xslt.Process: void main(java.lang.String[])>/javax.xml.parsers.SAXParserFactory.newInstance/0	<javax.xml.parsers.SAXParserFactory: javax.xml.parsers.SAXParserFactory newInstance()>
<org.apache.xalan.xslt.Process: void main(java.lang.String[])>/org.xml.sax.SAXException.<init>/0	<org.xml.sax.SAXException: void <init>(java.lang.Exception)>
<org.apache.xalan.xslt.Process: void main(java.lang.String[])>/org.xml.sax.SAXException.<init>/1	<org.xml.sax.SAXException: void <init>(java.lang.String)>
<org.apache.xalan.xslt.Process: void main(java.lang.String[])>/org.xml.sax.helpers.XMLReaderFactory.createXMLReader/0	<org.xml.sax.helpers.XMLReaderFactory: org.xml.sax.XMLReader createXMLReader()>
<org.apache.xalan.xslt.Process: void main(java.lang.String[])>/org.xml.sax.InputSource.<init>/2	<org.xml.sax.InputSource: void <init>(java.lang.String)>
<org.apache.xalan.xslt.Process: void main(java.lang.String[])>/javax.xml.parsers.SAXParserFactory.newInstance/1	<javax.xml.parsers.SAXParserFactory: javax.xml.parsers.SAXParserFactory newInstance()>
<org.apache.xalan.xslt.Process: void main(java.lang.String[])>/org.xml.sax.SAXException.<init>/2	<org.xml.sax.SAXException: void <init>(java.lang.Exception)>
<org.apache.xalan.xslt.Process: void main(java.lang.String[])>/org.xml.sax.SAXException.<init>/3	<org.xml.sax.SAXException: void <init>(java.lang.String)>
<org.apache.xalan.xslt.Process: void main(java.lang.String[])>/org.xml.sax.helpers.XMLReaderFactory.createXMLReader/1	<org.xml.sax.helpers.XMLReaderFactory: org.xml.sax.XMLReader createXMLReader()>
<org.apache.xalan.xslt.Process: void main(java.lang.String[])>/javax.xml.transform.sax.SAXResult.<init>/1	<javax.xml.transform.sax.SAXResult: void <init>(org.xml.sax.ContentHandler)>
<org.apache.xalan.xslt.Process: void main(java.lang.String[])>/org.xml.sax.InputSource.<init>/3	<org.xml.sax.InputSource: void <init>(java.lang.String)>
<org.apache.xalan.xslt.Process: void main(java.lang.String[])>/javax.xml.transform.sax.SAXSource.<init>/0	<javax.xml.transform.sax.SAXSource: void <init>(org.xml.sax.XMLReader,org.xml.sax.InputSource)>
<org.apache.xalan.xslt.Process: void main(java.lang.String[])>/org.xml.sax.InputSource.<init>/4	<org.xml.sax.InputSource: void <init>(java.lang.String)>
<org.apache.xalan.xslt.Process: void main(java.lang.String[])>/javax.xml.transform.sax.SAXSource.<init>/1	<javax.xml.transform.sax.SAXSource: void <init>(org.xml.sax.XMLReader,org.xml.sax.InputSource)>
<org.apache.xalan.xslt.Process: void main(java.lang.String[])>/javax.xml.transform.sax.SAXResult.<init>/2	<javax.xml.transform.sax.SAXResult: void <init>(org.xml.sax.ContentHandler)>
<org.apache.xalan.xslt.Process: void main(java.lang.String[])>/javax.xml.transform.stream.StreamSource.<init>/2	<javax.xml.transform.stream.StreamSource: void <init>(java.lang.String)>
<org.apache.xalan.xslt.Process: void main(java.lang.String[])>/javax.xml.transform.stream.StreamSource.<init>/3	<javax.xml.transform.stream.StreamSource: void <init>(java.lang.String)>
<org.apache.xalan.xslt.Process: void main(java.lang.String[])>/java.io.StringReader.<init>/0	<java.io.StringReader: void <init>(java.lang.String)>
<org.apache.xalan.xslt.Process: void main(java.lang.String[])>/javax.xml.transform.stream.StreamSource.<init>/4	<javax.xml.transform.stream.StreamSource: void <init>(java.io.Reader)>
<org.apache.xalan.xslt.Process: void main(java.lang.String[])>/org.apache.xalan.res.XSLMessages.createMessage/17	<org.apache.xalan.res.XSLMessages: java.lang.String createMessage(int,java.lang.Object[])>
<org.apache.xalan.xslt.Process: void main(java.lang.String[])>/java.io.PrintWriter.println/2	<java.io.PrintWriter: void println(java.lang.String)>
<org.apache.xalan.xslt.Process: void main(java.lang.String[])>/org.apache.xalan.xslt.Process.doExit/7	<org.apache.xalan.xslt.Process: void doExit(int)>
<org.apache.xalan.xslt.Process: void main(java.lang.String[])>/java.lang.System.currentTimeMillis/1	<java.lang.System: long currentTimeMillis()>
<org.apache.xalan.xslt.Process: void main(java.lang.String[])>/java.lang.StringBuffer.<init>/1	<java.lang.StringBuffer: void <init>(java.lang.String)>
<org.apache.xalan.xslt.Process: void main(java.lang.String[])>/java.lang.StringBuffer.append/3	<java.lang.StringBuffer: java.lang.StringBuffer append(java.lang.String)>
<org.apache.xalan.xslt.Process: void main(java.lang.String[])>/java.io.PrintWriter.println/3	<java.io.PrintWriter: void println(java.lang.String)>
<org.apache.xalan.xslt.Process: void main(java.lang.String[])>/java.io.PrintWriter.println/4	<java.io.PrintWriter: void println()>
<org.apache.xalan.xslt.Process: void main(java.lang.String[])>/java.lang.Throwable.printStackTrace/1	<java.lang.Throwable: void printStackTrace(java.io.PrintWriter)>
<org.apache.xalan.xslt.Process: void main(java.lang.String[])>/java.lang.Throwable.printStackTrace/1	<javax.xml.transform.TransformerException: void printStackTrace(java.io.PrintWriter)>
<org.apache.xalan.xslt.Process: void main(java.lang.String[])>/org.apache.xml.utils.DefaultErrorHandler.printLocation/0	<org.apache.xml.utils.DefaultErrorHandler: void printLocation(java.io.PrintWriter,java.lang.Throwable)>
<org.apache.xalan.xslt.Process: void main(java.lang.String[])>/org.apache.xalan.res.XSLMessages.createMessage/18	<org.apache.xalan.res.XSLMessages: java.lang.String createMessage(int,java.lang.Object[])>
<org.apache.xalan.xslt.Process: void main(java.lang.String[])>/java.lang.String.valueOf/1	<java.lang.String: java.lang.String valueOf(java.lang.Object)>
<org.apache.xalan.xslt.Process: void main(java.lang.String[])>/java.lang.StringBuffer.<init>/2	<java.lang.StringBuffer: void <init>(java.lang.String)>
<org.apache.xalan.xslt.Process: void main(java.lang.String[])>/java.lang.StringBuffer.append/9	<java.lang.StringBuffer: java.lang.StringBuffer append(java.lang.String)>
<org.apache.xalan.xslt.Process: void main(java.lang.String[])>/java.lang.Object.getClass/0	<java.lang.Object: java.lang.Class getClass()>
<org.apache.xalan.xslt.Process: void main(java.lang.String[])>/java.lang.Class.getName/0	<java.lang.Class: java.lang.String getName()>
<org.apache.xalan.xslt.Process: void main(java.lang.String[])>/java.lang.Throwable.getMessage/0	<java.lang.Throwable: java.lang.String getMessage()>
<org.apache.xalan.xslt.Process: void main(java.lang.String[])>/java.lang.Throwable.getMessage/0	<org.xml.sax.SAXException: java.lang.String getMessage()>
<org.apache.xalan.xslt.Process: void main(java.lang.String[])>/java.io.PrintWriter.println/5	<java.io.PrintWriter: void println(java.lang.String)>
<org.apache.xalan.xslt.Process: void main(java.lang.String[])>/java.io.PrintWriter.close/0	<java.io.PrintWriter: void close()>
<org.apache.xalan.xslt.Process: void main(java.lang.String[])>/org.apache.xalan.xslt.Process.doExit/8	<org.apache.xalan.xslt.Process: void doExit(int)>
<org.apache.xalan.xslt.Process: void main(java.lang.String[])>/java.io.PrintWriter.close/1	<java.io.PrintWriter: void close()>
<org.apache.xalan.xslt.Process: void main(java.lang.String[])>/java.io.PrintWriter.println/6	<java.io.PrintWriter: void println(java.lang.String)>
<org.apache.xml.utils.DefaultErrorHandler: void printLocation(java.io.PrintWriter,java.lang.Throwable)>/org.apache.xml.utils.SAXSourceLocator.<init>/0	<org.apache.xml.utils.SAXSourceLocator: void <init>(org.xml.sax.SAXParseException)>
<org.apache.xml.utils.DefaultErrorHandler: void printLocation(java.io.PrintWriter,java.lang.Throwable)>/javax.xml.transform.TransformerException.getLocator/0	<javax.xml.transform.TransformerException: javax.xml.transform.SourceLocator getLocator()>
<org.apache.xml.utils.DefaultErrorHandler: void printLocation(java.io.PrintWriter,java.lang.Throwable)>/javax.xml.transform.TransformerException.getCause/0	<javax.xml.transform.TransformerException: java.lang.Throwable getCause()>
<org.apache.xml.utils.DefaultErrorHandler: void printLocation(java.io.PrintWriter,java.lang.Throwable)>/org.xml.sax.SAXException.getException/0	<org.xml.sax.SAXException: java.lang.Exception getException()>
<org.apache.xml.utils.DefaultErrorHandler: void printLocation(java.io.PrintWriter,java.lang.Throwable)>/javax.xml.transform.SourceLocator.getPublicId/0	<org.apache.xml.utils.SAXSourceLocator: java.lang.String getPublicId()>
<org.apache.xml.utils.DefaultErrorHandler: void printLocation(java.io.PrintWriter,java.lang.Throwable)>/javax.xml.transform.SourceLocator.getPublicId/1	<org.apache.xml.utils.SAXSourceLocator: java.lang.String getPublicId()>
<org.apache.xml.utils.DefaultErrorHandler: void printLocation(java.io.PrintWriter,java.lang.Throwable)>/javax.xml.transform.SourceLocator.getPublicId/2	<org.apache.xml.utils.SAXSourceLocator: java.lang.String getPublicId()>
<org.apache.xml.utils.DefaultErrorHandler: void printLocation(java.io.PrintWriter,java.lang.Throwable)>/javax.xml.transform.SourceLocator.getSystemId/0	<org.apache.xml.utils.SAXSourceLocator: java.lang.String getSystemId()>
<org.apache.xml.utils.DefaultErrorHandler: void printLocation(java.io.PrintWriter,java.lang.Throwable)>/javax.xml.transform.SourceLocator.getSystemId/1	<org.apache.xml.utils.SAXSourceLocator: java.lang.String getSystemId()>
<org.apache.xml.utils.DefaultErrorHandler: void printLocation(java.io.PrintWriter,java.lang.Throwable)>/java.lang.String.valueOf/0	<java.lang.String: java.lang.String valueOf(java.lang.Object)>
<org.apache.xml.utils.DefaultErrorHandler: void printLocation(java.io.PrintWriter,java.lang.Throwable)>/java.lang.StringBuffer.<init>/0	<java.lang.StringBuffer: void <init>(java.lang.String)>
<org.apache.xml.utils.DefaultErrorHandler: void printLocation(java.io.PrintWriter,java.lang.Throwable)>/java.lang.StringBuffer.append/0	<java.lang.StringBuffer: java.lang.StringBuffer append(java.lang.String)>
<org.apache.xml.utils.DefaultErrorHandler: void printLocation(java.io.PrintWriter,java.lang.Throwable)>/javax.xml.transform.SourceLocator.getLineNumber/0	<org.apache.xml.utils.SAXSourceLocator: int getLineNumber()>
<org.apache.xml.utils.DefaultErrorHandler: void printLocation(java.io.PrintWriter,java.lang.Throwable)>/javax.xml.transform.SourceLocator.getColumnNumber/0	<org.apache.xml.utils.SAXSourceLocator: int getColumnNumber()>
<org.apache.xml.utils.DefaultErrorHandler: void printLocation(java.io.PrintWriter,java.lang.Throwable)>/java.io.PrintWriter.print/0	<java.io.PrintWriter: void print(java.lang.String)>
<org.apache.xml.utils.DefaultErrorHandler: void printLocation(java.io.PrintWriter,java.lang.Throwable)>/java.io.PrintWriter.print/1	<java.io.PrintWriter: void print(java.lang.String)>
<org.apache.xml.utils.SAXSourceLocator: int getColumnNumber()>/org.xml.sax.helpers.LocatorImpl.getColumnNumber/0	<org.xml.sax.helpers.LocatorImpl: int getColumnNumber()>
<org.apache.xml.utils.SAXSourceLocator: int getLineNumber()>/org.xml.sax.helpers.LocatorImpl.getLineNumber/0	<org.xml.sax.helpers.LocatorImpl: int getLineNumber()>
<org.apache.xml.utils.SAXSourceLocator: java.lang.String getPublicId()>/org.xml.sax.helpers.LocatorImpl.getPublicId/0	<org.xml.sax.helpers.LocatorImpl: java.lang.String getPublicId()>
<org.apache.xml.utils.SAXSourceLocator: java.lang.String getSystemId()>/org.xml.sax.helpers.LocatorImpl.getSystemId/0	<org.xml.sax.helpers.LocatorImpl: java.lang.String getSystemId()>
<org.apache.xml.utils.SAXSourceLocator: void <init>(org.xml.sax.SAXParseException)>/org.xml.sax.helpers.LocatorImpl.<init>/0	<org.xml.sax.helpers.LocatorImpl: void <init>()>
<org.apache.xml.utils.SAXSourceLocator: void <init>(org.xml.sax.SAXParseException)>/org.xml.sax.helpers.LocatorImpl.setLineNumber/0	<org.xml.sax.helpers.LocatorImpl: void setLineNumber(int)>
<org.apache.xml.utils.SAXSourceLocator: void <init>(org.xml.sax.SAXParseException)>/org.xml.sax.helpers.LocatorImpl.setColumnNumber/0	<org.xml.sax.helpers.LocatorImpl: void setColumnNumber(int)>
<org.apache.xml.utils.SAXSourceLocator: void <init>(org.xml.sax.SAXParseException)>/org.xml.sax.helpers.LocatorImpl.setPublicId/0	<org.xml.sax.helpers.LocatorImpl: void setPublicId(java.lang.String)>
<org.apache.xml.utils.SAXSourceLocator: void <init>(org.xml.sax.SAXParseException)>/org.xml.sax.helpers.LocatorImpl.setSystemId/0	<org.xml.sax.helpers.LocatorImpl: void setSystemId(java.lang.String)>
