<org.jfree.JCommon: void <clinit>()>/org.jfree.JCommonInfo.getInstance/0	<org.jfree.JCommonInfo: org.jfree.JCommonInfo getInstance()>
<org.jfree.JCommonInfo: java.lang.Class class$(java.lang.String)>/java.lang.Class.forName/0	<java.lang.Class: java.lang.Class forName(java.lang.String)>
<org.jfree.JCommonInfo: java.lang.Class class$(java.lang.String)>/java.lang.NoClassDefFoundError.<init>/0	<java.lang.NoClassDefFoundError: void <init>(java.lang.String)>
<org.jfree.JCommonInfo: org.jfree.JCommonInfo getInstance()>/org.jfree.JCommonInfo.<init>/0	<org.jfree.JCommonInfo: void <init>()>
<org.jfree.JCommonInfo: void <init>()>/org.jfree.ui.about.ProjectInfo.<init>/0	<org.jfree.ui.about.ProjectInfo: void <init>()>
<org.jfree.JCommonInfo: void <init>()>/java.util.ResourceBundle.getBundle/0	<java.util.ResourceBundle: java.util.ResourceBundle getBundle(java.lang.String)>
<org.jfree.JCommonInfo: void <init>()>/org.jfree.JCommonInfo.setName/0	<org.jfree.base.BasicProjectInfo: void setName(java.lang.String)>
<org.jfree.JCommonInfo: void <init>()>/org.jfree.JCommonInfo.setVersion/0	<org.jfree.base.BasicProjectInfo: void setVersion(java.lang.String)>
<org.jfree.JCommonInfo: void <init>()>/org.jfree.JCommonInfo.setInfo/0	<org.jfree.base.BasicProjectInfo: void setInfo(java.lang.String)>
<org.jfree.JCommonInfo: void <init>()>/org.jfree.JCommonInfo.setCopyright/0	<org.jfree.base.BasicProjectInfo: void setCopyright(java.lang.String)>
<org.jfree.JCommonInfo: void <init>()>/org.jfree.JCommonInfo.setLicenceName/0	<org.jfree.base.BasicProjectInfo: void setLicenceName(java.lang.String)>
<org.jfree.JCommonInfo: void <init>()>/org.jfree.ui.about.Licences.getInstance/0	<org.jfree.ui.about.Licences: org.jfree.ui.about.Licences getInstance()>
<org.jfree.JCommonInfo: void <init>()>/org.jfree.ui.about.Licences.getLGPL/0	<org.jfree.ui.about.Licences: java.lang.String getLGPL()>
<org.jfree.JCommonInfo: void <init>()>/org.jfree.JCommonInfo.setLicenceText/0	<org.jfree.ui.about.ProjectInfo: void setLicenceText(java.lang.String)>
<org.jfree.JCommonInfo: void <init>()>/org.jfree.ui.about.Contributor.<init>/0	<org.jfree.ui.about.Contributor: void <init>(java.lang.String,java.lang.String)>
<org.jfree.JCommonInfo: void <init>()>/org.jfree.ui.about.Contributor.<init>/1	<org.jfree.ui.about.Contributor: void <init>(java.lang.String,java.lang.String)>
<org.jfree.JCommonInfo: void <init>()>/org.jfree.ui.about.Contributor.<init>/2	<org.jfree.ui.about.Contributor: void <init>(java.lang.String,java.lang.String)>
<org.jfree.JCommonInfo: void <init>()>/org.jfree.ui.about.Contributor.<init>/3	<org.jfree.ui.about.Contributor: void <init>(java.lang.String,java.lang.String)>
<org.jfree.JCommonInfo: void <init>()>/org.jfree.ui.about.Contributor.<init>/4	<org.jfree.ui.about.Contributor: void <init>(java.lang.String,java.lang.String)>
<org.jfree.JCommonInfo: void <init>()>/org.jfree.ui.about.Contributor.<init>/5	<org.jfree.ui.about.Contributor: void <init>(java.lang.String,java.lang.String)>
<org.jfree.JCommonInfo: void <init>()>/org.jfree.ui.about.Contributor.<init>/6	<org.jfree.ui.about.Contributor: void <init>(java.lang.String,java.lang.String)>
<org.jfree.JCommonInfo: void <init>()>/org.jfree.ui.about.Contributor.<init>/7	<org.jfree.ui.about.Contributor: void <init>(java.lang.String,java.lang.String)>
<org.jfree.JCommonInfo: void <init>()>/org.jfree.ui.about.Contributor.<init>/8	<org.jfree.ui.about.Contributor: void <init>(java.lang.String,java.lang.String)>
<org.jfree.JCommonInfo: void <init>()>/org.jfree.ui.about.Contributor.<init>/9	<org.jfree.ui.about.Contributor: void <init>(java.lang.String,java.lang.String)>
<org.jfree.JCommonInfo: void <init>()>/org.jfree.ui.about.Contributor.<init>/10	<org.jfree.ui.about.Contributor: void <init>(java.lang.String,java.lang.String)>
<org.jfree.JCommonInfo: void <init>()>/org.jfree.ui.about.Contributor.<init>/11	<org.jfree.ui.about.Contributor: void <init>(java.lang.String,java.lang.String)>
<org.jfree.JCommonInfo: void <init>()>/org.jfree.ui.about.Contributor.<init>/12	<org.jfree.ui.about.Contributor: void <init>(java.lang.String,java.lang.String)>
<org.jfree.JCommonInfo: void <init>()>/org.jfree.ui.about.Contributor.<init>/13	<org.jfree.ui.about.Contributor: void <init>(java.lang.String,java.lang.String)>
<org.jfree.JCommonInfo: void <init>()>/org.jfree.ui.about.Contributor.<init>/14	<org.jfree.ui.about.Contributor: void <init>(java.lang.String,java.lang.String)>
<org.jfree.JCommonInfo: void <init>()>/org.jfree.ui.about.Contributor.<init>/15	<org.jfree.ui.about.Contributor: void <init>(java.lang.String,java.lang.String)>
<org.jfree.JCommonInfo: void <init>()>/org.jfree.ui.about.Contributor.<init>/16	<org.jfree.ui.about.Contributor: void <init>(java.lang.String,java.lang.String)>
<org.jfree.JCommonInfo: void <init>()>/java.util.Arrays.asList/0	<java.util.Arrays: java.util.List asList(java.lang.Object[])>
<org.jfree.JCommonInfo: void <init>()>/org.jfree.JCommonInfo.setContributors/0	<org.jfree.ui.about.ProjectInfo: void setContributors(java.util.List)>
<org.jfree.JCommonInfo: void <init>()>/org.jfree.base.Library.<init>/0	<org.jfree.base.Library: void <init>(java.lang.String,java.lang.String,java.lang.String,java.lang.String)>
<org.jfree.JCommonInfo: void <init>()>/org.jfree.JCommonInfo.addLibrary/0	<org.jfree.base.BasicProjectInfo: void addLibrary(org.jfree.base.Library)>
<org.jfree.JCommonInfo: void <init>()>/org.jfree.JCommonInfo.class$/0	<org.jfree.JCommonInfo: java.lang.Class class$(java.lang.String)>
<org.jfree.JCommonInfo: void <init>()>/java.lang.Class.getName/0	<java.lang.Class: java.lang.String getName()>
<org.jfree.JCommonInfo: void <init>()>/org.jfree.JCommonInfo.setBootClass/0	<org.jfree.base.BootableProjectInfo: void setBootClass(java.lang.String)>
<org.jfree.base.BasicProjectInfo: org.jfree.base.Library[] getLibraries()>/java.util.List.size/0	<java.util.ArrayList: int size()>
<org.jfree.base.BasicProjectInfo: org.jfree.base.Library[] getLibraries()>/java.util.List.toArray/0	<java.util.ArrayList: java.lang.Object[] toArray(java.lang.Object[])>
<org.jfree.base.BasicProjectInfo: void <init>()>/org.jfree.base.Library.<init>/0	<org.jfree.base.Library: void <init>()>
<org.jfree.base.BasicProjectInfo: void <init>()>/java.util.ArrayList.<init>/0	<java.util.ArrayList: void <init>()>
<org.jfree.base.BasicProjectInfo: void addLibrary(org.jfree.base.Library)>/java.lang.NullPointerException.<init>/0	<java.lang.NullPointerException: void <init>()>
<org.jfree.base.BasicProjectInfo: void addLibrary(org.jfree.base.Library)>/java.util.List.add/0	<java.util.ArrayList: boolean add(java.lang.Object)>
<org.jfree.base.BasicProjectInfo: void setInfo(java.lang.String)>/org.jfree.base.Library.setInfo/0	<org.jfree.base.Library: void setInfo(java.lang.String)>
<org.jfree.base.BasicProjectInfo: void setLicenceName(java.lang.String)>/org.jfree.base.Library.setLicenceName/0	<org.jfree.base.Library: void setLicenceName(java.lang.String)>
<org.jfree.base.BasicProjectInfo: void setName(java.lang.String)>/org.jfree.base.Library.setName/0	<org.jfree.base.Library: void setName(java.lang.String)>
<org.jfree.base.BasicProjectInfo: void setVersion(java.lang.String)>/org.jfree.base.Library.setVersion/0	<org.jfree.base.Library: void setVersion(java.lang.String)>
<org.jfree.base.BootableProjectInfo: void <init>()>/org.jfree.base.BasicProjectInfo.<init>/0	<org.jfree.base.BasicProjectInfo: void <init>()>
<org.jfree.base.BootableProjectInfo: void <init>()>/java.util.ArrayList.<init>/0	<java.util.ArrayList: void <init>()>
<org.jfree.base.Library: void <init>()>/java.lang.Object.<init>/0	<java.lang.Object: void <init>()>
<org.jfree.base.Library: void <init>(java.lang.String,java.lang.String,java.lang.String,java.lang.String)>/java.lang.Object.<init>/0	<java.lang.Object: void <init>()>
<org.jfree.chart.JFreeChart: void <clinit>()>/org.jfree.chart.JFreeChartInfo.<init>/0	<org.jfree.chart.JFreeChartInfo: void <init>()>
<org.jfree.chart.JFreeChart: void main(java.lang.String[])>/org.jfree.ui.about.ProjectInfo.toString/0	<org.jfree.ui.about.ProjectInfo: java.lang.String toString()>
<org.jfree.chart.JFreeChartInfo: void <init>()>/org.jfree.ui.about.ProjectInfo.<init>/0	<org.jfree.ui.about.ProjectInfo: void <init>()>
<org.jfree.chart.JFreeChartInfo: void <init>()>/java.util.ResourceBundle.getBundle/0	<java.util.ResourceBundle: java.util.ResourceBundle getBundle(java.lang.String)>
<org.jfree.chart.JFreeChartInfo: void <init>()>/org.jfree.chart.JFreeChartInfo.setName/0	<org.jfree.base.BasicProjectInfo: void setName(java.lang.String)>
<org.jfree.chart.JFreeChartInfo: void <init>()>/org.jfree.chart.JFreeChartInfo.setVersion/0	<org.jfree.base.BasicProjectInfo: void setVersion(java.lang.String)>
<org.jfree.chart.JFreeChartInfo: void <init>()>/org.jfree.chart.JFreeChartInfo.setInfo/0	<org.jfree.base.BasicProjectInfo: void setInfo(java.lang.String)>
<org.jfree.chart.JFreeChartInfo: void <init>()>/org.jfree.chart.JFreeChartInfo.setCopyright/0	<org.jfree.base.BasicProjectInfo: void setCopyright(java.lang.String)>
<org.jfree.chart.JFreeChartInfo: void <init>()>/org.jfree.chart.JFreeChartInfo.setLogo/0	<org.jfree.ui.about.ProjectInfo: void setLogo(java.awt.Image)>
<org.jfree.chart.JFreeChartInfo: void <init>()>/org.jfree.chart.JFreeChartInfo.setLicenceName/0	<org.jfree.base.BasicProjectInfo: void setLicenceName(java.lang.String)>
<org.jfree.chart.JFreeChartInfo: void <init>()>/org.jfree.ui.about.Licences.getInstance/0	<org.jfree.ui.about.Licences: org.jfree.ui.about.Licences getInstance()>
<org.jfree.chart.JFreeChartInfo: void <init>()>/org.jfree.ui.about.Licences.getLGPL/0	<org.jfree.ui.about.Licences: java.lang.String getLGPL()>
<org.jfree.chart.JFreeChartInfo: void <init>()>/org.jfree.chart.JFreeChartInfo.setLicenceText/0	<org.jfree.ui.about.ProjectInfo: void setLicenceText(java.lang.String)>
<org.jfree.chart.JFreeChartInfo: void <init>()>/org.jfree.ui.about.Contributor.<init>/0	<org.jfree.ui.about.Contributor: void <init>(java.lang.String,java.lang.String)>
<org.jfree.chart.JFreeChartInfo: void <init>()>/org.jfree.ui.about.Contributor.<init>/1	<org.jfree.ui.about.Contributor: void <init>(java.lang.String,java.lang.String)>
<org.jfree.chart.JFreeChartInfo: void <init>()>/org.jfree.ui.about.Contributor.<init>/2	<org.jfree.ui.about.Contributor: void <init>(java.lang.String,java.lang.String)>
<org.jfree.chart.JFreeChartInfo: void <init>()>/org.jfree.ui.about.Contributor.<init>/3	<org.jfree.ui.about.Contributor: void <init>(java.lang.String,java.lang.String)>
<org.jfree.chart.JFreeChartInfo: void <init>()>/org.jfree.ui.about.Contributor.<init>/4	<org.jfree.ui.about.Contributor: void <init>(java.lang.String,java.lang.String)>
<org.jfree.chart.JFreeChartInfo: void <init>()>/org.jfree.ui.about.Contributor.<init>/5	<org.jfree.ui.about.Contributor: void <init>(java.lang.String,java.lang.String)>
<org.jfree.chart.JFreeChartInfo: void <init>()>/org.jfree.ui.about.Contributor.<init>/6	<org.jfree.ui.about.Contributor: void <init>(java.lang.String,java.lang.String)>
<org.jfree.chart.JFreeChartInfo: void <init>()>/org.jfree.ui.about.Contributor.<init>/7	<org.jfree.ui.about.Contributor: void <init>(java.lang.String,java.lang.String)>
<org.jfree.chart.JFreeChartInfo: void <init>()>/org.jfree.ui.about.Contributor.<init>/8	<org.jfree.ui.about.Contributor: void <init>(java.lang.String,java.lang.String)>
<org.jfree.chart.JFreeChartInfo: void <init>()>/org.jfree.ui.about.Contributor.<init>/9	<org.jfree.ui.about.Contributor: void <init>(java.lang.String,java.lang.String)>
<org.jfree.chart.JFreeChartInfo: void <init>()>/org.jfree.ui.about.Contributor.<init>/10	<org.jfree.ui.about.Contributor: void <init>(java.lang.String,java.lang.String)>
<org.jfree.chart.JFreeChartInfo: void <init>()>/org.jfree.ui.about.Contributor.<init>/11	<org.jfree.ui.about.Contributor: void <init>(java.lang.String,java.lang.String)>
<org.jfree.chart.JFreeChartInfo: void <init>()>/org.jfree.ui.about.Contributor.<init>/12	<org.jfree.ui.about.Contributor: void <init>(java.lang.String,java.lang.String)>
<org.jfree.chart.JFreeChartInfo: void <init>()>/org.jfree.ui.about.Contributor.<init>/13	<org.jfree.ui.about.Contributor: void <init>(java.lang.String,java.lang.String)>
<org.jfree.chart.JFreeChartInfo: void <init>()>/org.jfree.ui.about.Contributor.<init>/14	<org.jfree.ui.about.Contributor: void <init>(java.lang.String,java.lang.String)>
<org.jfree.chart.JFreeChartInfo: void <init>()>/org.jfree.ui.about.Contributor.<init>/15	<org.jfree.ui.about.Contributor: void <init>(java.lang.String,java.lang.String)>
<org.jfree.chart.JFreeChartInfo: void <init>()>/org.jfree.ui.about.Contributor.<init>/16	<org.jfree.ui.about.Contributor: void <init>(java.lang.String,java.lang.String)>
<org.jfree.chart.JFreeChartInfo: void <init>()>/org.jfree.ui.about.Contributor.<init>/17	<org.jfree.ui.about.Contributor: void <init>(java.lang.String,java.lang.String)>
<org.jfree.chart.JFreeChartInfo: void <init>()>/org.jfree.ui.about.Contributor.<init>/18	<org.jfree.ui.about.Contributor: void <init>(java.lang.String,java.lang.String)>
<org.jfree.chart.JFreeChartInfo: void <init>()>/org.jfree.ui.about.Contributor.<init>/19	<org.jfree.ui.about.Contributor: void <init>(java.lang.String,java.lang.String)>
<org.jfree.chart.JFreeChartInfo: void <init>()>/org.jfree.ui.about.Contributor.<init>/20	<org.jfree.ui.about.Contributor: void <init>(java.lang.String,java.lang.String)>
<org.jfree.chart.JFreeChartInfo: void <init>()>/org.jfree.ui.about.Contributor.<init>/21	<org.jfree.ui.about.Contributor: void <init>(java.lang.String,java.lang.String)>
<org.jfree.chart.JFreeChartInfo: void <init>()>/org.jfree.ui.about.Contributor.<init>/22	<org.jfree.ui.about.Contributor: void <init>(java.lang.String,java.lang.String)>
<org.jfree.chart.JFreeChartInfo: void <init>()>/org.jfree.ui.about.Contributor.<init>/23	<org.jfree.ui.about.Contributor: void <init>(java.lang.String,java.lang.String)>
<org.jfree.chart.JFreeChartInfo: void <init>()>/org.jfree.ui.about.Contributor.<init>/24	<org.jfree.ui.about.Contributor: void <init>(java.lang.String,java.lang.String)>
<org.jfree.chart.JFreeChartInfo: void <init>()>/org.jfree.ui.about.Contributor.<init>/25	<org.jfree.ui.about.Contributor: void <init>(java.lang.String,java.lang.String)>
<org.jfree.chart.JFreeChartInfo: void <init>()>/org.jfree.ui.about.Contributor.<init>/26	<org.jfree.ui.about.Contributor: void <init>(java.lang.String,java.lang.String)>
<org.jfree.chart.JFreeChartInfo: void <init>()>/org.jfree.ui.about.Contributor.<init>/27	<org.jfree.ui.about.Contributor: void <init>(java.lang.String,java.lang.String)>
<org.jfree.chart.JFreeChartInfo: void <init>()>/org.jfree.ui.about.Contributor.<init>/28	<org.jfree.ui.about.Contributor: void <init>(java.lang.String,java.lang.String)>
<org.jfree.chart.JFreeChartInfo: void <init>()>/org.jfree.ui.about.Contributor.<init>/29	<org.jfree.ui.about.Contributor: void <init>(java.lang.String,java.lang.String)>
<org.jfree.chart.JFreeChartInfo: void <init>()>/org.jfree.ui.about.Contributor.<init>/30	<org.jfree.ui.about.Contributor: void <init>(java.lang.String,java.lang.String)>
<org.jfree.chart.JFreeChartInfo: void <init>()>/org.jfree.ui.about.Contributor.<init>/31	<org.jfree.ui.about.Contributor: void <init>(java.lang.String,java.lang.String)>
<org.jfree.chart.JFreeChartInfo: void <init>()>/org.jfree.ui.about.Contributor.<init>/32	<org.jfree.ui.about.Contributor: void <init>(java.lang.String,java.lang.String)>
<org.jfree.chart.JFreeChartInfo: void <init>()>/org.jfree.ui.about.Contributor.<init>/33	<org.jfree.ui.about.Contributor: void <init>(java.lang.String,java.lang.String)>
<org.jfree.chart.JFreeChartInfo: void <init>()>/org.jfree.ui.about.Contributor.<init>/34	<org.jfree.ui.about.Contributor: void <init>(java.lang.String,java.lang.String)>
<org.jfree.chart.JFreeChartInfo: void <init>()>/org.jfree.ui.about.Contributor.<init>/35	<org.jfree.ui.about.Contributor: void <init>(java.lang.String,java.lang.String)>
<org.jfree.chart.JFreeChartInfo: void <init>()>/org.jfree.ui.about.Contributor.<init>/36	<org.jfree.ui.about.Contributor: void <init>(java.lang.String,java.lang.String)>
<org.jfree.chart.JFreeChartInfo: void <init>()>/org.jfree.ui.about.Contributor.<init>/37	<org.jfree.ui.about.Contributor: void <init>(java.lang.String,java.lang.String)>
<org.jfree.chart.JFreeChartInfo: void <init>()>/org.jfree.ui.about.Contributor.<init>/38	<org.jfree.ui.about.Contributor: void <init>(java.lang.String,java.lang.String)>
<org.jfree.chart.JFreeChartInfo: void <init>()>/org.jfree.ui.about.Contributor.<init>/39	<org.jfree.ui.about.Contributor: void <init>(java.lang.String,java.lang.String)>
<org.jfree.chart.JFreeChartInfo: void <init>()>/org.jfree.ui.about.Contributor.<init>/40	<org.jfree.ui.about.Contributor: void <init>(java.lang.String,java.lang.String)>
<org.jfree.chart.JFreeChartInfo: void <init>()>/org.jfree.ui.about.Contributor.<init>/41	<org.jfree.ui.about.Contributor: void <init>(java.lang.String,java.lang.String)>
<org.jfree.chart.JFreeChartInfo: void <init>()>/org.jfree.ui.about.Contributor.<init>/42	<org.jfree.ui.about.Contributor: void <init>(java.lang.String,java.lang.String)>
<org.jfree.chart.JFreeChartInfo: void <init>()>/org.jfree.ui.about.Contributor.<init>/43	<org.jfree.ui.about.Contributor: void <init>(java.lang.String,java.lang.String)>
<org.jfree.chart.JFreeChartInfo: void <init>()>/org.jfree.ui.about.Contributor.<init>/44	<org.jfree.ui.about.Contributor: void <init>(java.lang.String,java.lang.String)>
<org.jfree.chart.JFreeChartInfo: void <init>()>/org.jfree.ui.about.Contributor.<init>/45	<org.jfree.ui.about.Contributor: void <init>(java.lang.String,java.lang.String)>
<org.jfree.chart.JFreeChartInfo: void <init>()>/org.jfree.ui.about.Contributor.<init>/46	<org.jfree.ui.about.Contributor: void <init>(java.lang.String,java.lang.String)>
<org.jfree.chart.JFreeChartInfo: void <init>()>/org.jfree.ui.about.Contributor.<init>/47	<org.jfree.ui.about.Contributor: void <init>(java.lang.String,java.lang.String)>
<org.jfree.chart.JFreeChartInfo: void <init>()>/org.jfree.ui.about.Contributor.<init>/48	<org.jfree.ui.about.Contributor: void <init>(java.lang.String,java.lang.String)>
<org.jfree.chart.JFreeChartInfo: void <init>()>/org.jfree.ui.about.Contributor.<init>/49	<org.jfree.ui.about.Contributor: void <init>(java.lang.String,java.lang.String)>
<org.jfree.chart.JFreeChartInfo: void <init>()>/org.jfree.ui.about.Contributor.<init>/50	<org.jfree.ui.about.Contributor: void <init>(java.lang.String,java.lang.String)>
<org.jfree.chart.JFreeChartInfo: void <init>()>/org.jfree.ui.about.Contributor.<init>/51	<org.jfree.ui.about.Contributor: void <init>(java.lang.String,java.lang.String)>
<org.jfree.chart.JFreeChartInfo: void <init>()>/org.jfree.ui.about.Contributor.<init>/52	<org.jfree.ui.about.Contributor: void <init>(java.lang.String,java.lang.String)>
<org.jfree.chart.JFreeChartInfo: void <init>()>/org.jfree.ui.about.Contributor.<init>/53	<org.jfree.ui.about.Contributor: void <init>(java.lang.String,java.lang.String)>
<org.jfree.chart.JFreeChartInfo: void <init>()>/org.jfree.ui.about.Contributor.<init>/54	<org.jfree.ui.about.Contributor: void <init>(java.lang.String,java.lang.String)>
<org.jfree.chart.JFreeChartInfo: void <init>()>/org.jfree.ui.about.Contributor.<init>/55	<org.jfree.ui.about.Contributor: void <init>(java.lang.String,java.lang.String)>
<org.jfree.chart.JFreeChartInfo: void <init>()>/org.jfree.ui.about.Contributor.<init>/56	<org.jfree.ui.about.Contributor: void <init>(java.lang.String,java.lang.String)>
<org.jfree.chart.JFreeChartInfo: void <init>()>/org.jfree.ui.about.Contributor.<init>/57	<org.jfree.ui.about.Contributor: void <init>(java.lang.String,java.lang.String)>
<org.jfree.chart.JFreeChartInfo: void <init>()>/org.jfree.ui.about.Contributor.<init>/58	<org.jfree.ui.about.Contributor: void <init>(java.lang.String,java.lang.String)>
<org.jfree.chart.JFreeChartInfo: void <init>()>/org.jfree.ui.about.Contributor.<init>/59	<org.jfree.ui.about.Contributor: void <init>(java.lang.String,java.lang.String)>
<org.jfree.chart.JFreeChartInfo: void <init>()>/org.jfree.ui.about.Contributor.<init>/60	<org.jfree.ui.about.Contributor: void <init>(java.lang.String,java.lang.String)>
<org.jfree.chart.JFreeChartInfo: void <init>()>/java.util.Arrays.asList/0	<java.util.Arrays: java.util.List asList(java.lang.Object[])>
<org.jfree.chart.JFreeChartInfo: void <init>()>/org.jfree.chart.JFreeChartInfo.setContributors/0	<org.jfree.ui.about.ProjectInfo: void setContributors(java.util.List)>
<org.jfree.chart.JFreeChartInfo: void <init>()>/org.jfree.ui.about.Library.<init>/0	<org.jfree.ui.about.Library: void <init>(org.jfree.ui.about.ProjectInfo)>
<org.jfree.chart.JFreeChartInfo: void <init>()>/java.util.Arrays.asList/1	<java.util.Arrays: java.util.List asList(java.lang.Object[])>
<org.jfree.ui.about.Contributor: void <init>(java.lang.String,java.lang.String)>/java.lang.Object.<init>/0	<java.lang.Object: void <init>()>
<org.jfree.ui.about.Library: void <init>(java.lang.String,java.lang.String,java.lang.String,java.lang.String)>/org.jfree.base.Library.<init>/0	<org.jfree.base.Library: void <init>(java.lang.String,java.lang.String,java.lang.String,java.lang.String)>
<org.jfree.ui.about.Library: void <init>(org.jfree.ui.about.ProjectInfo)>/org.jfree.ui.about.ProjectInfo.getName/0	<org.jfree.base.Library: java.lang.String getName()>
<org.jfree.ui.about.Library: void <init>(org.jfree.ui.about.ProjectInfo)>/org.jfree.ui.about.ProjectInfo.getVersion/0	<org.jfree.base.Library: java.lang.String getVersion()>
<org.jfree.ui.about.Library: void <init>(org.jfree.ui.about.ProjectInfo)>/org.jfree.ui.about.ProjectInfo.getLicenceName/0	<org.jfree.base.Library: java.lang.String getLicenceName()>
<org.jfree.ui.about.Library: void <init>(org.jfree.ui.about.ProjectInfo)>/org.jfree.ui.about.ProjectInfo.getInfo/0	<org.jfree.base.Library: java.lang.String getInfo()>
<org.jfree.ui.about.Library: void <init>(org.jfree.ui.about.ProjectInfo)>/org.jfree.ui.about.Library.<init>/0	<org.jfree.ui.about.Library: void <init>(java.lang.String,java.lang.String,java.lang.String,java.lang.String)>
<org.jfree.ui.about.Licences: org.jfree.ui.about.Licences getInstance()>/org.jfree.ui.about.Licences.<init>/0	<org.jfree.ui.about.Licences: void <init>()>
<org.jfree.ui.about.Licences: void <init>()>/java.lang.Object.<init>/0	<java.lang.Object: void <init>()>
<org.jfree.ui.about.ProjectInfo: java.lang.String toString()>/java.lang.StringBuffer.<init>/0	<java.lang.StringBuffer: void <init>()>
<org.jfree.ui.about.ProjectInfo: java.lang.String toString()>/org.jfree.ui.about.ProjectInfo.getName/0	<org.jfree.base.Library: java.lang.String getName()>
<org.jfree.ui.about.ProjectInfo: java.lang.String toString()>/java.lang.StringBuffer.append/0	<java.lang.StringBuffer: java.lang.StringBuffer append(java.lang.String)>
<org.jfree.ui.about.ProjectInfo: java.lang.String toString()>/java.lang.StringBuffer.append/1	<java.lang.StringBuffer: java.lang.StringBuffer append(java.lang.String)>
<org.jfree.ui.about.ProjectInfo: java.lang.String toString()>/org.jfree.ui.about.ProjectInfo.getVersion/0	<org.jfree.base.Library: java.lang.String getVersion()>
<org.jfree.ui.about.ProjectInfo: java.lang.String toString()>/java.lang.StringBuffer.append/2	<java.lang.StringBuffer: java.lang.StringBuffer append(java.lang.String)>
<org.jfree.ui.about.ProjectInfo: java.lang.String toString()>/java.lang.StringBuffer.append/3	<java.lang.StringBuffer: java.lang.StringBuffer append(java.lang.String)>
<org.jfree.ui.about.ProjectInfo: java.lang.String toString()>/org.jfree.ui.about.ProjectInfo.getCopyright/0	<org.jfree.base.BasicProjectInfo: java.lang.String getCopyright()>
<org.jfree.ui.about.ProjectInfo: java.lang.String toString()>/java.lang.StringBuffer.append/4	<java.lang.StringBuffer: java.lang.StringBuffer append(java.lang.String)>
<org.jfree.ui.about.ProjectInfo: java.lang.String toString()>/java.lang.StringBuffer.append/5	<java.lang.StringBuffer: java.lang.StringBuffer append(java.lang.String)>
<org.jfree.ui.about.ProjectInfo: java.lang.String toString()>/java.lang.StringBuffer.append/6	<java.lang.StringBuffer: java.lang.StringBuffer append(java.lang.String)>
<org.jfree.ui.about.ProjectInfo: java.lang.String toString()>/java.lang.StringBuffer.append/7	<java.lang.StringBuffer: java.lang.StringBuffer append(java.lang.String)>
<org.jfree.ui.about.ProjectInfo: java.lang.String toString()>/java.lang.StringBuffer.append/8	<java.lang.StringBuffer: java.lang.StringBuffer append(java.lang.String)>
<org.jfree.ui.about.ProjectInfo: java.lang.String toString()>/java.lang.StringBuffer.append/9	<java.lang.StringBuffer: java.lang.StringBuffer append(java.lang.String)>
<org.jfree.ui.about.ProjectInfo: java.lang.String toString()>/org.jfree.ui.about.ProjectInfo.getInfo/0	<org.jfree.base.Library: java.lang.String getInfo()>
<org.jfree.ui.about.ProjectInfo: java.lang.String toString()>/java.lang.StringBuffer.append/10	<java.lang.StringBuffer: java.lang.StringBuffer append(java.lang.String)>
<org.jfree.ui.about.ProjectInfo: java.lang.String toString()>/java.lang.StringBuffer.append/11	<java.lang.StringBuffer: java.lang.StringBuffer append(java.lang.String)>
<org.jfree.ui.about.ProjectInfo: java.lang.String toString()>/java.lang.StringBuffer.append/12	<java.lang.StringBuffer: java.lang.StringBuffer append(java.lang.String)>
<org.jfree.ui.about.ProjectInfo: java.lang.String toString()>/java.lang.StringBuffer.append/13	<java.lang.StringBuffer: java.lang.StringBuffer append(java.lang.String)>
<org.jfree.ui.about.ProjectInfo: java.lang.String toString()>/java.lang.StringBuffer.append/14	<java.lang.StringBuffer: java.lang.StringBuffer append(java.lang.String)>
<org.jfree.ui.about.ProjectInfo: java.lang.String toString()>/java.lang.StringBuffer.append/15	<java.lang.StringBuffer: java.lang.StringBuffer append(java.lang.String)>
<org.jfree.ui.about.ProjectInfo: java.lang.String toString()>/java.lang.StringBuffer.append/16	<java.lang.StringBuffer: java.lang.StringBuffer append(java.lang.String)>
<org.jfree.ui.about.ProjectInfo: java.lang.String toString()>/java.lang.StringBuffer.append/17	<java.lang.StringBuffer: java.lang.StringBuffer append(java.lang.String)>
<org.jfree.ui.about.ProjectInfo: java.lang.String toString()>/java.lang.StringBuffer.append/18	<java.lang.StringBuffer: java.lang.StringBuffer append(java.lang.String)>
<org.jfree.ui.about.ProjectInfo: java.lang.String toString()>/java.lang.StringBuffer.append/19	<java.lang.StringBuffer: java.lang.StringBuffer append(java.lang.String)>
<org.jfree.ui.about.ProjectInfo: java.lang.String toString()>/org.jfree.ui.about.ProjectInfo.getName/1	<org.jfree.base.Library: java.lang.String getName()>
<org.jfree.ui.about.ProjectInfo: java.lang.String toString()>/java.lang.StringBuffer.append/20	<java.lang.StringBuffer: java.lang.StringBuffer append(java.lang.String)>
<org.jfree.ui.about.ProjectInfo: java.lang.String toString()>/java.lang.StringBuffer.append/21	<java.lang.StringBuffer: java.lang.StringBuffer append(java.lang.String)>
<org.jfree.ui.about.ProjectInfo: java.lang.String toString()>/org.jfree.ui.about.ProjectInfo.getLibraries/0	<org.jfree.base.BasicProjectInfo: org.jfree.base.Library[] getLibraries()>
<org.jfree.ui.about.ProjectInfo: java.lang.String toString()>/java.lang.StringBuffer.append/22	<java.lang.StringBuffer: java.lang.StringBuffer append(java.lang.String)>
<org.jfree.ui.about.ProjectInfo: java.lang.String toString()>/java.lang.StringBuffer.append/23	<java.lang.StringBuffer: java.lang.StringBuffer append(java.lang.String)>
<org.jfree.ui.about.ProjectInfo: java.lang.String toString()>/java.lang.StringBuffer.append/24	<java.lang.StringBuffer: java.lang.StringBuffer append(java.lang.String)>
<org.jfree.ui.about.ProjectInfo: java.lang.String toString()>/java.lang.StringBuffer.append/25	<java.lang.StringBuffer: java.lang.StringBuffer append(java.lang.String)>
<org.jfree.ui.about.ProjectInfo: java.lang.String toString()>/java.lang.StringBuffer.append/26	<java.lang.StringBuffer: java.lang.StringBuffer append(java.lang.String)>
<org.jfree.ui.about.ProjectInfo: java.lang.String toString()>/java.lang.StringBuffer.append/27	<java.lang.StringBuffer: java.lang.StringBuffer append(java.lang.String)>
<org.jfree.ui.about.ProjectInfo: java.lang.String toString()>/java.lang.StringBuffer.append/28	<java.lang.StringBuffer: java.lang.StringBuffer append(java.lang.String)>
<org.jfree.ui.about.ProjectInfo: java.lang.String toString()>/java.lang.StringBuffer.append/29	<java.lang.StringBuffer: java.lang.StringBuffer append(java.lang.String)>
<org.jfree.ui.about.ProjectInfo: java.lang.String toString()>/org.jfree.ui.about.ProjectInfo.getName/2	<org.jfree.base.Library: java.lang.String getName()>
<org.jfree.ui.about.ProjectInfo: java.lang.String toString()>/java.lang.StringBuffer.append/30	<java.lang.StringBuffer: java.lang.StringBuffer append(java.lang.String)>
<org.jfree.ui.about.ProjectInfo: java.lang.String toString()>/java.lang.StringBuffer.append/31	<java.lang.StringBuffer: java.lang.StringBuffer append(java.lang.String)>
<org.jfree.ui.about.ProjectInfo: java.lang.String toString()>/java.lang.StringBuffer.append/32	<java.lang.StringBuffer: java.lang.StringBuffer append(java.lang.String)>
<org.jfree.ui.about.ProjectInfo: java.lang.String toString()>/org.jfree.ui.about.ProjectInfo.getLicenceText/0	<org.jfree.ui.about.ProjectInfo: java.lang.String getLicenceText()>
<org.jfree.ui.about.ProjectInfo: java.lang.String toString()>/java.lang.StringBuffer.append/33	<java.lang.StringBuffer: java.lang.StringBuffer append(java.lang.String)>
<org.jfree.ui.about.ProjectInfo: java.lang.String toString()>/java.lang.StringBuffer.toString/0	<java.lang.StringBuffer: java.lang.String toString()>
<org.jfree.ui.about.ProjectInfo: void <init>()>/org.jfree.base.BootableProjectInfo.<init>/0	<org.jfree.base.BootableProjectInfo: void <init>()>
